32 20
4 5 6 7 4 5 6 7 4 5 6 7 4 5 6 7 4 5 6 7 4 5 6 7 4 5 6 7 4 5 6 7 
8 9 10 11 8 9 10 11 8 9 10 11 8 9 10 11 8 9 10 11 8 9 10 11 8 9 10 11 8 9 10 11 
12 13 14 15 12 13 14 15 12 13 14 15 12 13 14 15 12 13 14 15 12 13 14 15 12 13 14 15 12 13 14 15 
105 105 105 105 105 105 105 105 105 105 105 105 105 105 105 105 105 105 105 105 105 105 105 105 105 105 105 105 105 105 105 105 
105 105 105 105 105 105 105 105 105 105 105 105 105 105 105 105 105 105 105 105 105 105 105 105 105 105 105 105 105 105 105 105 
105 105 105 105 105 105 105 105 105 105 105 105 105 105 105 105 105 105 105 105 105 105 105 105 105 105 105 105 105 105 105 105 
105 105 105 105 105 105 105 105 105 105 105 105 105 105 105 105 105 105 105 105 105 105 105 105 105 105 105 105 105 105 105 105 
105 105 105 105 105 105 105 105 105 105 105 105 105 105 105 105 105 105 105 105 105 105 105 105 105 105 105 105 105 105 105 105 
20 21 22 23 20 155 156 23 20 21 22 23 20 155 156 23 20 21 22 23 20 155 156 23 20 21 22 23 20 155 156 23 
8 9 10 11 8 157 158 11 8 9 10 11 8 157 158 11 8 9 10 11 8 157 158 11 8 9 10 11 8 157 158 11 
12 13 14 15 12 159 160 15 12 13 14 15 12 159 160 15 12 13 14 15 12 159 160 15 12 13 14 15 12 159 160 15 
105 105 105 105 105 105 105 105 105 105 105 105 105 105 105 105 105 105 105 105 105 105 105 105 105 105 105 105 105 105 105 105 
105 105 105 105 105 105 105 105 105 105 105 105 105 105 105 105 105 105 105 105 105 105 105 105 105 105 105 105 105 105 105 105 
105 105 105 105 105 105 105 105 105 105 105 105 105 105 105 105 105 105 105 105 105 105 105 105 105 105 105 105 105 105 105 105 
105 105 105 105 105 105 105 105 105 105 105 105 105 105 105 105 105 105 105 105 105 105 105 105 105 105 105 105 105 105 105 105 
105 105 105 105 105 105 105 105 105 105 105 105 105 105 105 105 105 105 105 105 105 105 105 105 105 105 105 105 105 105 105 105 
20 155 156 23 20 21 22 23 20 155 156 23 20 21 22 23 20 155 156 23 20 21 22 23 20 155 156 23 20 21 22 23 
8 157 158 11 8 9 10 11 8 157 158 11 8 9 10 11 8 157 158 11 8 9 10 11 8 157 158 11 8 9 10 11 
12 159 160 15 12 13 14 15 12 159 160 15 12 13 14 15 12 159 160 15 12 13 14 15 12 159 160 15 12 13 14 15 
105 105 105 105 105 105 105 105 105 105 105 105 105 105 105 105 105 105 105 105 105 105 105 105 105 105 105 105 105 105 105 105 

7 
LADDER 224 0 3 0
STONE 240 144 -3
STONE 112 272 0
STONE 384 16 0
ENEMY SKELETON 128 16
ENEMY SKELETON 272 144
ENEMY SKELETON 352 272
