32 20
105 105 105 105 105 105 105 105 36 37 38 39 36 37 38 39 36 37 38 39 36 37 38 39 36 37 38 39 36 37 105 105 
105 105 105 105 105 105 105 105 24 25 26 27 24 25 26 27 24 25 26 27 24 25 26 27 24 25 26 27 24 25 105 105 
105 105 105 105 105 105 105 105 28 29 30 31 28 29 30 31 28 29 30 31 28 29 30 31 28 29 30 31 28 29 105 105 
105 105 105 105 105 105 105 105 32 33 34 35 32 33 34 35 106 106 105 105 105 105 105 105 106 106 105 105 105 105 105 105 
105 105 105 105 105 105 105 105 36 37 38 39 36 37 38 39 40 41 42 43 40 41 42 43 40 41 42 43 40 119 120 43 
105 105 105 105 105 105 105 105 24 25 26 27 24 25 26 27 24 25 26 27 24 25 26 27 24 25 26 27 24 121 122 27 
105 105 105 105 105 105 105 105 28 29 30 31 28 29 30 31 28 29 30 31 28 29 30 31 28 29 30 31 28 123 124 31 
105 105 105 105 105 105 105 105 32 33 34 35 105 105 105 105 106 106 105 105 105 105 34 35 105 105 105 105 105 105 105 105 
105 105 105 105 105 105 105 105 36 37 38 39 40 41 42 43 40 41 42 43 40 41 38 39 105 105 105 105 105 105 105 105 
105 105 105 105 105 105 105 105 24 25 26 27 24 25 26 27 24 25 26 27 24 25 26 27 105 105 105 105 105 105 105 105 
105 105 105 105 105 105 105 105 28 29 30 31 28 29 30 31 28 29 30 31 28 29 30 31 105 105 105 105 105 105 105 105 
105 105 105 105 105 105 105 105 106 106 105 105 105 105 34 35 32 33 34 35 105 105 105 105 105 105 105 105 105 105 105 105 
105 105 105 105 105 105 105 105 40 41 42 43 40 41 38 39 36 37 38 39 40 41 42 43 40 119 120 43 40 41 42 43 
105 105 105 105 105 105 105 105 24 25 26 27 24 25 26 27 24 25 26 27 24 25 26 27 24 121 122 27 24 25 26 27 
105 105 105 105 105 105 105 105 28 29 30 31 28 29 30 31 28 29 30 31 28 29 30 31 28 123 124 31 28 29 30 31 
105 105 105 105 105 105 105 105 32 33 34 35 105 105 105 105 106 106 105 105 105 105 34 35 105 105 105 105 105 105 105 105 
105 105 105 105 105 105 105 105 36 37 38 39 40 41 42 43 40 41 42 43 40 41 38 39 40 41 42 43 40 119 120 43 
105 105 105 105 105 105 105 105 24 25 26 27 24 25 26 27 24 25 26 27 24 25 26 27 24 25 26 27 24 121 122 27 
105 105 105 105 105 105 105 105 28 29 30 31 28 29 30 31 28 29 30 31 28 29 30 31 28 29 30 31 28 123 124 31 
105 105 105 105 105 105 105 105 32 33 34 35 32 33 34 35 105 105 105 105 105 105 105 105 105 105 105 105 105 105 105 105 

15 
LADDER 384 0 3 0
LADDER 384 64 3 0
LADDER 256 0 3 0
LADDER 256 64 3 0
LADDER 256 128 7 0
LADDER 256 256 3 0
LADDER 128 192 9 0
LADDER 128 0 11 0
STONE 352 144 -1
STONE 288 80 0
STONE 416 272 0
ENEMY BOUNCINGBALL 288 32 2
ENEMY BOUNCINGBALL 288 288 4
ENEMY BOUNCINGBALL 320 96 3
ENEMY BOUNCINGBALL 320 224 4

SLIME