32 20
105 105 50 51 48 49 50 51 48 49 50 51 48 49 50 51 48 49 50 51 48 49 50 51 105 105 105 105 105 105 105 105 
105 105 54 55 52 53 54 55 52 53 54 55 52 53 54 55 52 53 54 55 52 53 54 55 105 105 105 105 105 105 105 105 
105 105 58 59 56 57 58 59 56 57 58 59 56 57 58 59 56 57 58 59 56 57 58 59 105 105 105 105 105 105 105 105 
105 105 105 105 106 106 105 105 105 105 105 105 105 105 105 105 105 105 105 105 44 45 46 47 105 105 105 105 105 105 105 105 
105 105 105 105 60 61 62 63 60 70 71 63 60 61 62 63 105 105 105 105 48 49 50 51 60 61 62 63 60 61 105 105 
105 105 105 105 52 53 54 55 52 72 73 55 52 53 54 55 105 105 105 105 52 53 54 55 52 53 54 55 52 53 105 105 
105 105 105 105 56 57 58 59 56 74 75 59 56 57 58 59 105 105 105 105 56 57 58 59 56 57 58 59 56 57 105 105 
105 105 105 105 44 45 46 47 105 105 105 105 44 45 46 47 105 105 105 105 105 105 105 105 44 45 46 47 44 45 105 105 
105 105 105 105 48 49 50 51 105 105 62 63 48 49 50 51 60 70 71 63 60 61 105 105 48 49 50 51 48 49 105 105 
105 105 105 105 52 53 54 55 105 105 54 55 52 53 54 55 52 72 73 55 52 53 105 105 52 53 54 55 52 53 105 105 
105 105 105 105 56 57 58 59 105 105 58 59 56 57 58 59 56 74 75 59 56 57 105 105 56 57 58 59 56 57 105 105 
105 105 105 105 44 45 46 47 105 105 46 47 105 105 105 105 105 105 105 105 105 105 105 105 44 45 46 47 105 105 105 105 
105 105 105 105 48 49 50 51 105 105 50 51 60 61 105 105 60 61 62 63 60 70 71 63 48 49 50 51 60 61 105 105 
105 105 105 105 52 53 54 55 105 105 54 55 52 53 105 105 52 53 54 55 52 72 73 55 52 53 54 55 52 53 105 105 
105 105 105 105 56 57 58 59 105 105 58 59 56 57 105 105 56 57 58 59 56 74 75 59 56 57 58 59 56 57 105 105 
105 105 105 105 44 45 46 47 105 105 105 105 44 45 105 105 44 45 46 47 105 105 105 105 106 106 105 105 105 105 105 105 
105 105 105 105 48 49 50 51 105 105 62 63 48 49 105 105 48 49 50 51 105 105 105 105 60 61 62 63 60 61 105 105 
105 105 105 105 52 53 54 55 105 105 54 55 52 53 105 105 52 53 54 55 105 105 105 105 52 53 54 55 52 53 105 105 
105 105 105 105 56 57 58 59 105 105 58 59 56 57 105 105 56 57 58 59 105 105 105 105 56 57 58 59 56 57 105 105 
105 105 105 105 105 105 46 47 105 105 105 105 105 105 105 105 105 105 105 105 105 105 105 105 44 45 46 47 44 45 105 105 

6 
LADDER 384 256 5 0
LADDER 64 64 15 0
STONE 128 16 -2
STONE 416 208 0
ENEMY SKELETON 256 144
ENEMY SKELETON 160 16

FALLINGSTONES
