32 20
105 105 105 105 0 1 0 1 0 1 0 1 0 1 0 1 0 1 0 1 0 1 0 1 0 1 0 1 0 1 105 105 
105 105 105 105 1 0 1 0 1 0 1 0 1 0 1 0 1 0 1 0 1 0 1 0 1 0 1 0 1 0 105 105 
105 105 105 105 0 1 0 1 0 1 0 1 0 1 0 1 0 1 0 1 0 1 0 1 0 1 0 1 0 1 105 105 
105 105 105 105 105 105 105 105 105 105 105 105 105 105 105 105 105 105 105 105 105 105 105 105 105 105 1 0 105 105 105 105 
2 3 2 3 2 3 2 3 2 3 2 3 2 76 77 3 2 3 2 3 105 105 105 105 105 105 0 1 2 3 105 105 
1 0 1 0 1 0 1 0 1 0 1 0 1 78 79 0 1 0 1 0 105 105 105 105 105 105 1 0 1 0 105 105 
0 1 0 1 0 1 0 1 0 1 0 1 0 80 81 1 0 1 0 1 105 105 105 105 105 105 0 1 0 1 105 105 
1 0 1 0 1 0 1 0 1 0 1 0 105 105 105 105 105 105 106 106 105 105 105 105 105 105 105 105 1 0 105 105 
0 1 0 1 0 1 0 1 0 1 0 1 2 3 2 3 2 3 2 3 2 3 2 3 2 3 2 3 0 1 105 105 
1 0 1 0 1 0 1 0 1 0 1 0 1 0 1 0 1 0 1 0 1 0 1 0 1 0 1 0 1 0 105 105 
0 1 0 1 0 1 0 1 0 1 0 1 0 1 0 1 0 1 0 1 0 1 0 1 0 1 0 1 0 1 105 105 
105 105 105 105 105 105 105 105 1 0 1 0 1 0 1 0 105 105 105 105 105 105 105 105 1 0 1 0 105 105 105 105 
105 105 105 105 2 3 2 3 0 1 0 1 0 1 0 1 105 105 105 105 105 105 105 105 0 1 0 1 2 3 105 105 
105 105 105 105 1 0 1 0 1 0 1 0 1 0 1 0 105 105 105 105 105 105 105 105 1 0 1 0 1 0 105 105 
105 105 105 105 0 1 0 1 0 1 0 1 0 1 0 1 105 105 105 105 105 105 105 105 0 1 0 1 0 1 105 105 
105 105 105 105 1 0 1 0 1 0 1 0 105 105 105 105 105 105 105 105 105 105 105 105 105 105 105 105 105 105 105 105 
105 105 105 105 0 1 0 1 0 1 0 1 2 3 2 3 2 94 95 3 2 3 2 3 2 94 95 3 2 3 105 105 
105 105 105 105 1 0 1 0 1 0 1 0 1 0 1 0 1 96 97 0 1 0 1 0 1 96 97 0 1 0 105 105 
105 105 105 105 0 1 0 1 0 1 0 1 0 1 0 1 0 1 0 1 0 1 0 1 0 1 0 1 0 1 105 105 
105 105 105 105 105 105 105 105 105 105 105 105 105 105 105 105 105 105 105 105 105 105 105 105 105 105 105 105 105 105 105 105 

8 
LADDER 288 128 3 0
STONE 416 80 0
STONE 160 16 -3
STONE 192 208 0
ENEMY WORM 256 272 0
ENEMY WORM 352 144 0
ENEMY WORM 128 16 0
ENEMY KNIGHTHEAD 224 96
