32 20
105 105 105 105 4 5 6 7 4 5 6 7 4 5 6 7 4 5 6 7 4 5 6 7 105 105 105 105 4 5 6 7 
105 105 105 105 8 9 10 11 8 9 10 11 8 9 10 11 8 9 10 11 8 9 10 11 105 105 105 105 8 9 10 11 
105 105 105 105 12 13 14 15 12 13 14 15 12 13 14 15 12 13 14 15 12 13 14 15 105 105 105 105 12 13 14 15 
105 105 105 105 105 105 105 105 105 105 105 105 105 105 105 105 16 17 18 19 16 17 18 19 105 105 105 105 105 105 105 105 
105 105 105 105 105 105 105 105 105 105 105 105 105 105 105 105 4 5 6 7 4 5 6 7 105 105 105 105 20 21 22 23 
105 105 105 105 105 105 105 105 105 105 105 105 105 105 105 105 8 9 10 11 8 9 10 11 105 105 105 105 8 9 10 11 
105 105 105 105 105 105 105 105 105 105 105 105 105 105 105 105 12 13 14 15 12 13 14 15 105 105 105 105 12 13 14 15 
105 105 105 105 105 105 105 105 105 105 105 105 105 105 105 105 16 17 18 19 16 17 18 19 105 105 105 105 16 17 105 105 
105 105 105 105 105 105 105 105 105 105 105 105 105 105 105 105 4 5 6 7 4 5 6 7 105 105 105 105 4 5 22 23 
105 105 105 105 105 105 105 105 105 105 105 105 105 105 105 105 8 9 10 11 8 9 10 11 105 105 105 105 8 9 10 11 
105 105 105 105 105 105 105 105 105 105 105 105 105 105 105 105 12 13 14 15 12 13 14 15 105 105 105 105 12 13 14 15 
105 105 105 105 105 105 105 105 105 105 105 105 105 105 105 105 16 17 105 105 105 105 105 105 105 105 105 105 105 105 105 105 
105 105 105 105 20 21 22 23 20 155 156 23 20 21 22 23 4 5 22 23 20 155 156 23 20 21 22 23 20 21 22 23 
105 105 105 105 8 9 10 11 8 157 158 11 8 9 10 11 8 9 10 11 8 157 158 11 8 9 10 11 8 9 10 11 
105 105 105 105 12 13 14 15 12 159 160 15 12 13 14 15 12 13 14 15 12 159 160 15 12 13 14 15 12 13 14 15 
105 105 105 105 105 105 105 105 106 106 105 105 105 105 105 105 105 105 18 19 105 105 105 105 105 105 18 19 16 17 105 105 
105 105 105 105 20 155 156 23 20 21 22 23 20 155 156 23 20 21 6 7 20 21 22 23 20 21 6 7 4 5 22 23 
105 105 105 105 8 157 158 11 8 9 10 11 8 157 158 11 8 9 10 11 8 9 10 11 8 9 10 11 8 9 10 11 
105 105 105 105 12 159 160 15 12 13 14 15 12 159 160 15 12 13 14 15 12 13 14 15 12 13 14 15 12 13 14 15 
105 105 105 105 105 105 105 105 105 105 105 105 105 105 105 105 105 105 105 105 105 105 105 105 105 105 105 105 105 105 105 105 

11 
LADDER 128 256 3 0
LADDER 288 0 11 0
ENEMY BAT 160 80
ENEMY BAT 448 64
ENEMY BAT 448 192
ENEMY BAT 224 256
ENEMY BAMBU 288 272
ENEMY BAMBU 352 208
ENEMY BAMBU 448 144
ENEMY BAMBU 320 144
ENEMY BAMBU 160 16
