32 20
105 105 105 105 105 105 105 105 105 105 105 105 105 105 105 105 105 105 105 105 4 5 6 7 4 5 6 7 105 105 105 105 
105 105 105 105 105 105 105 105 105 105 105 105 105 105 105 105 105 105 105 105 8 9 10 11 8 9 10 11 105 105 105 105 
105 105 105 105 105 105 105 105 105 105 105 105 105 105 105 105 105 105 105 105 12 13 14 15 12 13 14 15 105 105 105 105 
105 105 105 105 105 105 105 105 105 105 105 105 105 105 105 105 105 105 105 105 16 17 18 19 16 17 18 19 105 105 105 105 
105 105 105 105 105 105 105 105 105 105 105 105 105 105 105 105 105 105 105 105 4 5 6 7 4 5 6 7 105 105 105 105 
105 105 105 105 105 105 105 105 105 105 105 105 105 105 105 105 105 105 105 105 8 9 10 11 8 9 10 11 105 105 105 105 
105 105 105 105 105 105 105 105 105 105 105 105 105 105 105 105 105 105 105 105 12 13 14 15 12 13 14 15 105 105 105 105 
105 105 105 105 105 105 105 105 105 105 105 105 105 105 105 105 105 105 105 105 16 17 18 19 105 105 18 19 105 105 105 105 
166 166 166 166 166 166 166 166 166 166 166 166 166 166 166 166 4 5 6 7 4 5 6 7 20 21 6 7 105 105 105 105 
166 166 166 166 166 166 166 166 166 166 166 166 166 166 166 166 8 9 10 11 8 9 10 11 8 9 10 11 105 105 105 105 
166 166 166 166 166 166 166 166 166 166 166 166 105 105 105 105 12 13 14 15 12 13 14 15 12 13 14 15 105 105 105 105 
105 105 105 105 105 105 105 105 166 166 166 166 105 105 105 105 105 105 105 105 16 17 18 19 16 17 18 19 105 105 105 105 
105 105 105 105 105 105 105 105 166 166 105 105 105 105 105 105 105 105 105 105 4 5 6 7 4 5 6 7 105 105 105 105 
105 105 105 105 105 105 105 105 166 166 105 105 105 105 105 105 105 105 105 105 8 9 10 11 8 9 10 11 105 105 105 105 
105 105 105 105 105 105 105 105 166 166 105 105 105 105 105 105 105 105 105 105 12 13 14 15 12 13 14 15 105 105 105 105 
105 105 105 105 105 105 105 105 166 166 105 105 105 105 105 105 105 105 105 105 16 17 18 19 105 105 18 19 105 105 105 105 
105 105 105 105 105 105 105 105 166 166 105 105 105 105 105 105 105 105 105 105 4 5 6 7 20 21 6 7 105 105 105 105 
105 105 105 105 105 105 105 105 166 166 105 105 105 105 105 105 105 105 105 105 8 9 10 11 8 9 10 11 105 105 105 105 
105 105 105 105 105 105 105 105 166 166 105 105 105 105 105 105 105 105 105 105 12 13 14 15 12 13 14 15 105 105 105 105 
105 105 105 105 105 105 105 105 166 166 105 105 105 105 105 105 105 105 105 105 16 17 18 19 16 17 18 19 105 105 105 105 

1
HITWALL 256 128 3