32 20
4 5 6 7 105 105 105 105 105 105 6 7 4 5 6 7 4 5 6 7 4 5 6 7 4 5 6 7 4 5 6 7 
8 9 10 11 105 105 105 105 105 105 10 11 8 9 10 11 8 9 10 11 8 9 10 11 8 9 10 11 8 9 10 11 
12 13 14 15 105 105 105 105 105 105 14 15 12 13 14 15 12 13 14 15 12 13 14 15 12 13 14 15 12 13 14 15 
105 105 18 19 105 105 105 105 105 105 18 19 16 17 18 19 16 17 18 19 105 105 105 105 105 105 105 105 105 105 105 105 
20 21 6 7 105 105 105 105 105 105 6 7 4 5 6 7 4 5 6 7 20 21 22 23 20 21 22 23 20 155 156 23 
8 9 10 11 105 105 105 105 105 105 10 11 8 9 10 11 8 9 10 11 8 9 10 11 8 9 10 11 8 157 158 11 
12 13 14 15 105 105 105 105 105 105 14 15 12 13 14 15 12 13 14 15 12 13 14 15 12 13 14 15 12 159 160 15 
105 105 105 105 105 105 105 105 105 105 105 105 105 105 105 105 106 106 105 105 16 17 18 19 105 105 105 105 105 105 105 105 
20 21 22 23 105 105 105 105 105 105 22 23 20 155 156 23 20 21 22 23 4 5 6 7 20 155 156 23 20 21 22 23 
8 9 10 11 105 105 105 105 105 105 10 11 8 157 158 11 8 9 10 11 8 9 10 11 8 157 158 11 8 9 10 11 
12 13 14 15 105 105 105 105 105 105 14 15 12 159 160 15 12 13 14 15 12 13 14 15 12 159 160 15 12 13 14 15 
105 105 18 19 105 105 105 105 105 105 105 105 105 105 105 105 106 106 105 105 105 105 105 105 105 105 105 105 105 105 105 105 
20 21 6 7 105 105 105 105 105 105 22 23 20 21 22 23 20 21 22 23 20 21 22 23 20 21 22 23 20 155 156 23 
8 9 10 11 105 105 105 105 105 105 10 11 8 9 10 11 8 9 10 11 8 9 10 11 8 9 10 11 8 157 158 11 
12 13 14 15 105 105 105 105 105 105 14 15 12 13 14 15 12 13 14 15 12 13 14 15 12 13 14 15 12 159 160 15 
105 105 105 105 105 105 105 105 105 105 18 19 105 105 105 105 105 105 105 105 16 17 18 19 105 105 105 105 105 105 105 105 
20 21 22 23 20 155 156 23 20 21 6 7 20 155 156 23 20 155 156 23 4 5 6 7 20 155 156 23 20 21 22 23 
8 9 10 11 8 157 158 11 8 9 10 11 8 157 158 11 8 157 158 11 8 9 10 11 8 157 158 11 8 9 10 11 
12 13 14 15 12 159 160 15 12 13 14 15 12 159 160 15 12 159 160 15 12 13 14 15 12 159 160 15 12 13 14 15 
105 105 105 105 105 105 105 105 105 105 105 105 105 105 105 105 105 105 105 105 105 105 105 105 105 105 105 105 105 105 105 105 

11 
LADDER 256 0 7 0
LADDER 256 128 3 0
LADDER 256 192 3 0
STONE 160 80 0
STONE 112 272 0
STONE 416 80 0
KEYDOOR 304 128 1
ENEMY KNIGHT 192 80
ENEMY KNIGHT 224 144
ENEMY KNIGHT 224 208
ENEMY KNIGHT 256 272
