32 20
105 105 0 1 0 1 0 1 0 1 0 1 0 1 0 1 0 1 0 1 0 1 0 1 105 105 105 105 0 1 0 1 
105 105 1 0 1 0 1 0 1 0 1 0 1 0 1 0 1 0 1 0 1 0 1 0 105 105 105 105 1 0 1 0 
105 105 0 1 0 1 0 1 0 1 0 1 0 1 0 1 0 1 0 1 0 1 0 1 105 105 105 105 0 1 0 1 
105 105 105 105 105 105 105 105 105 105 105 105 105 105 105 105 105 105 105 105 105 105 106 106 105 105 105 105 1 0 1 0 
105 105 2 3 2 3 2 3 2 3 2 3 2 3 2 3 2 3 2 3 2 3 2 3 105 105 105 105 0 1 0 1 
105 105 1 0 1 0 1 0 1 0 1 0 1 0 1 0 1 0 1 0 1 0 1 0 105 105 105 105 1 0 1 0 
105 105 0 1 0 1 0 1 0 1 0 1 0 1 0 1 0 1 0 1 0 1 0 1 105 105 105 105 0 1 0 1 
105 105 1 0 1 0 105 105 105 105 105 105 105 105 105 105 1 0 1 0 105 105 105 105 105 105 105 105 1 0 1 0 
105 105 0 1 0 1 2 3 2 3 2 3 2 3 2 3 0 1 0 1 2 3 2 3 2 3 2 3 0 1 0 1 
105 105 1 0 1 0 1 0 1 0 1 0 1 0 1 0 1 0 1 0 1 0 1 0 1 0 1 0 1 0 1 0 
105 105 0 1 0 1 0 1 0 1 0 1 0 1 0 1 0 1 0 1 0 1 0 1 0 1 0 1 0 1 0 1 
105 105 105 105 1 0 1 0 105 105 105 105 105 105 1 0 1 0 1 0 1 0 1 0 105 105 1 0 1 0 105 105 
105 105 2 3 0 1 0 1 105 105 105 105 2 3 0 1 0 1 0 1 0 1 0 1 2 3 0 1 0 1 105 105 
105 105 1 0 1 0 1 0 105 105 105 105 1 0 1 0 1 0 1 0 1 0 1 0 1 0 1 0 1 0 105 105 
105 105 0 1 0 1 0 1 105 105 105 105 0 1 0 1 0 1 0 1 0 1 0 1 0 1 0 1 0 1 105 105 
105 105 1 0 105 105 1 0 105 105 105 105 1 0 1 0 105 105 105 105 105 105 105 105 1 0 1 0 1 0 105 105 
105 105 0 1 2 3 0 1 105 105 105 105 0 1 0 1 2 3 2 3 2 64 65 3 0 1 0 1 0 1 105 105 
105 105 1 0 1 0 1 0 105 105 105 105 1 0 1 0 1 0 1 0 1 66 67 0 1 0 1 0 1 0 105 105 
105 105 0 1 0 1 0 1 105 105 105 105 0 1 0 1 0 1 0 1 0 68 69 1 0 1 0 1 0 1 105 105 
105 105 105 105 105 105 105 105 105 105 105 105 105 105 105 105 105 105 105 105 105 105 105 105 105 105 105 105 105 105 105 105 
7
ARMOUR 32 256 1
ARMOUR 448 256 0
LADDER 352 64 3 0
WDOOR 128 64 1
ENEMY SKELETON 128 16
ENEMY SKELETON 256 208
ENEMY SKELETON 384 272
