32 20
105 105 105 105 4 5 6 7 4 5 6 7 4 5 6 7 4 5 6 7 105 105 105 105 4 5 6 7 4 5 6 7 
105 105 105 105 8 9 10 11 8 9 10 11 8 9 10 11 8 9 10 11 105 105 105 105 8 9 10 11 8 9 10 11 
105 105 105 105 12 13 14 15 12 13 14 15 12 13 14 15 12 13 14 15 105 105 105 105 12 13 14 15 12 13 14 15 
105 105 105 105 105 105 105 105 105 105 105 105 105 105 105 105 16 17 18 19 105 105 105 105 105 105 105 105 105 105 105 105 
105 105 105 105 105 105 105 105 105 105 105 105 105 105 105 105 4 5 6 7 20 155 156 23 20 21 22 23 20 155 156 23 
105 105 105 105 105 105 105 105 105 105 105 105 105 105 105 105 8 9 10 11 8 157 158 11 8 9 10 11 8 157 158 11 
105 105 105 105 105 105 105 105 105 105 105 105 105 105 105 105 12 13 14 15 12 159 160 15 12 13 14 15 12 159 160 15 
105 105 105 105 105 105 105 105 105 105 105 105 105 105 105 105 16 17 18 19 106 106 105 105 105 105 105 105 105 105 105 105 
105 105 105 105 105 105 105 105 105 105 105 105 105 105 105 105 4 5 6 7 20 21 22 23 105 105 105 105 20 21 22 23 
105 105 105 105 105 105 105 105 105 105 105 105 105 105 105 105 8 9 10 11 8 9 10 11 105 105 105 105 8 9 10 11 
105 105 105 105 105 105 105 105 105 105 105 105 105 105 105 105 12 13 14 15 12 13 14 15 105 105 105 105 12 13 14 15 
105 105 105 105 105 105 105 105 105 105 105 105 105 105 105 105 106 106 105 105 105 105 105 105 105 105 105 105 16 17 105 105 
105 105 105 105 105 105 105 105 105 105 105 105 105 105 105 105 20 21 22 23 20 21 22 23 105 105 105 105 4 5 22 23 
105 105 105 105 105 105 105 105 105 105 105 105 105 105 105 105 8 9 10 11 8 9 10 11 105 105 105 105 8 9 10 11 
105 105 105 105 105 105 105 105 105 105 105 105 105 105 105 105 12 13 14 15 12 13 14 15 105 105 105 105 12 13 14 15 
105 105 105 105 105 105 105 105 105 105 105 105 105 105 105 105 16 17 18 19 16 17 18 19 105 105 105 105 105 105 105 105 
105 105 105 105 105 105 105 105 105 105 105 105 105 105 105 105 4 5 6 7 4 5 6 7 105 105 105 105 20 21 22 23 
105 105 105 105 105 105 105 105 105 105 105 105 105 105 105 105 8 9 10 11 8 9 10 11 105 105 105 105 8 9 10 11 
105 105 105 105 105 105 105 105 105 105 105 105 105 105 105 105 12 13 14 15 12 13 14 15 105 105 105 105 12 13 14 15 
105 105 105 105 105 105 105 105 105 105 105 105 105 105 105 105 105 105 105 105 16 17 18 19 105 105 105 105 16 17 105 105 

12 
LADDER 384 0 3 0
LADDER 320 128 3 0
LADDER 256 192 7 0
STONE 400 80 -1
STONE 112 16 0
ENEMY PORCUPINE 368 80
ENEMY PORCUPINE 288 144
ENEMY PORCUPINE 192 16
ENEMY BAMBU 416 16
ENEMY BAMBU 320 144
ENEMY BAMBU 352 80
ENEMY BAMBU 160 16
