32 20
105 105 50 51 48 49 50 51 48 49 50 51 48 49 50 51 48 49 50 51 48 49 50 51 48 49 50 51 48 49 50 51 
105 105 54 55 52 53 54 55 52 53 54 55 52 53 54 55 52 53 54 55 52 53 54 55 52 53 54 55 52 53 54 55 
105 105 58 59 56 57 58 59 56 57 58 59 56 57 58 59 56 57 58 59 56 57 58 59 56 57 58 59 56 57 58 59 
105 105 46 47 44 45 46 47 44 45 46 47 44 45 46 47 44 45 46 47 44 45 46 47 44 45 46 47 44 45 46 47 
60 61 50 51 48 49 50 51 48 49 50 51 48 49 50 51 48 49 50 51 48 49 50 51 48 49 50 51 48 49 50 51 
52 53 54 55 52 53 54 55 52 53 54 55 52 53 54 55 52 53 54 55 52 53 54 55 52 53 54 55 52 53 54 55 
56 57 58 59 56 57 58 59 56 57 58 59 56 57 58 59 56 57 58 59 56 57 58 59 56 57 58 59 56 57 58 59 
105 105 46 47 44 45 46 47 44 45 46 47 44 45 46 47 44 45 46 47 44 45 46 47 44 45 46 47 44 45 105 105 
105 105 50 51 48 49 50 51 48 49 50 51 48 49 50 51 48 49 50 51 48 49 50 51 48 49 50 51 48 49 105 105 
105 105 54 55 52 53 54 55 52 53 54 55 52 53 54 55 52 53 54 55 52 53 54 55 52 53 54 55 52 53 105 105 
105 105 58 59 56 57 58 59 56 57 58 59 56 57 58 59 56 57 58 59 56 57 58 59 56 57 58 59 56 57 105 105 
105 105 46 47 44 45 46 47 44 45 46 47 44 45 46 47 44 45 46 47 44 45 46 47 44 45 46 47 44 45 105 105 
60 61 50 51 48 49 50 51 48 49 50 51 48 49 50 51 48 49 50 51 48 49 50 51 48 49 50 51 48 49 105 105 
52 53 54 55 52 53 54 55 52 53 54 55 52 53 54 55 52 53 54 55 52 53 54 55 52 53 54 55 52 53 105 105 
56 57 58 59 56 57 58 59 56 57 58 59 56 57 58 59 56 57 58 59 56 57 58 59 56 57 58 59 56 57 105 105 
105 105 46 47 44 45 46 47 44 45 46 47 44 45 46 47 44 45 46 47 44 45 46 47 44 45 46 47 44 45 105 105 
105 105 50 51 48 49 50 51 48 49 50 51 48 49 50 51 48 49 50 51 48 49 50 51 48 49 50 51 48 49 105 105 
105 105 54 55 52 53 54 55 52 53 54 55 52 53 54 55 52 53 54 55 52 53 54 55 52 53 54 55 52 53 105 105 
105 105 58 59 56 57 58 59 56 57 58 59 56 57 58 59 56 57 58 59 56 57 58 59 56 57 58 59 56 57 105 105 
105 105 105 105 105 105 105 105 105 105 105 105 105 105 105 105 105 105 105 105 105 105 105 105 105 105 105 105 105 105 105 105 

2 
ENEMY KNIGHT 32 272
ENEMY KNIGHT 256 272
