32 20
105 105 6 7 4 5 6 7 4 5 6 7 4 5 6 7 4 5 6 7 4 5 6 7 4 5 6 7 4 5 6 7 
105 105 10 11 8 9 10 11 8 9 10 11 8 9 10 11 8 9 10 11 8 9 10 11 8 9 10 11 8 9 10 11 
105 105 14 15 12 13 14 15 12 13 14 15 12 13 14 15 12 13 14 15 12 13 14 15 12 13 14 15 12 13 14 15 
105 105 18 19 16 17 18 19 16 17 18 19 16 17 18 19 16 17 18 19 16 17 18 19 16 17 18 19 16 17 18 19 
105 105 6 7 4 5 6 7 4 5 6 7 4 5 6 7 4 5 6 7 4 5 6 7 4 5 6 7 4 5 6 7 
105 105 10 11 8 9 10 11 8 9 10 11 8 9 10 11 8 9 10 11 8 9 10 11 8 9 10 11 8 9 10 11 
105 105 14 15 12 13 14 15 12 13 14 15 12 13 14 15 12 13 14 15 12 13 14 15 12 13 14 15 12 13 14 15 
105 105 18 19 16 17 18 19 16 17 18 19 16 17 18 19 16 17 18 19 16 17 18 19 16 17 18 19 16 17 18 19 
105 105 6 7 4 5 6 7 4 5 6 7 4 5 6 7 4 5 6 7 4 5 6 7 4 5 6 7 4 5 6 7 
105 105 10 11 8 9 10 11 8 9 10 11 8 9 10 11 8 9 10 11 8 9 10 11 8 9 10 11 8 9 10 11 
105 105 14 15 12 13 14 15 12 13 14 15 12 13 14 15 12 13 14 15 12 13 14 15 12 13 14 15 12 13 14 15 
105 105 18 19 16 17 18 19 16 17 18 19 16 17 18 19 16 17 18 19 16 17 18 19 16 17 18 19 105 105 105 105 
105 105 6 7 4 5 6 7 4 5 6 7 4 5 6 7 4 5 6 7 4 5 6 7 4 5 6 7 105 105 105 105 
105 105 10 11 8 9 10 11 8 9 10 11 8 9 10 11 8 9 10 11 8 9 10 11 8 9 10 11 105 105 105 105 
105 105 14 15 12 13 14 15 12 13 14 15 12 13 14 15 12 13 14 15 12 13 14 15 12 13 14 15 105 105 105 105 
105 105 18 19 16 17 18 19 16 17 18 19 16 17 18 19 16 17 18 19 16 17 18 19 16 17 18 19 105 105 105 105 
105 105 6 7 4 5 6 7 4 5 6 7 4 5 6 7 4 5 6 7 4 5 6 7 4 5 6 7 105 105 105 105 
105 105 10 11 8 9 10 11 8 9 10 11 8 9 10 11 8 9 10 11 8 9 10 11 8 9 10 11 105 105 105 105 
105 105 14 15 12 13 14 15 12 13 14 15 12 13 14 15 12 13 14 15 12 13 14 15 12 13 14 15 105 105 105 105 
105 105 105 105 105 105 105 105 105 105 105 105 105 105 18 19 16 17 105 105 105 105 105 105 105 105 105 105 105 105 105 105 

3 
STONE 128 272 0
ENEMY BAT 64 0
ENEMY BAT 64 0
