32 20
105 105 0 1 0 1 0 1 0 1 0 1 0 1 0 1 0 1 0 1 0 1 0 1 0 1 0 1 0 1 105 105 
105 105 1 0 1 0 1 0 1 0 1 0 1 0 1 0 1 0 1 0 1 0 1 0 1 0 1 0 1 0 105 105 
105 105 0 1 0 1 0 1 0 1 0 1 0 1 0 1 0 1 0 1 0 1 0 1 0 1 0 1 0 1 105 105 
105 105 1 0 1 0 106 106 105 105 105 105 105 105 106 106 1 0 1 0 1 0 106 106 105 105 105 105 105 105 105 105 
105 105 0 1 0 1 2 3 2 3 2 3 2 3 2 3 0 1 0 1 0 1 2 3 2 3 2 3 2 3 2 3 
105 105 1 0 1 0 1 0 1 0 1 0 1 0 1 0 1 0 1 0 1 0 1 0 1 0 1 0 1 0 1 0 
105 105 0 1 0 1 0 1 0 1 0 1 0 1 0 1 0 1 0 1 0 1 0 1 0 1 0 1 0 1 0 1 
105 105 105 105 105 105 106 106 1 0 1 0 1 0 106 106 105 105 105 105 105 105 106 106 1 0 1 0 1 0 105 105 
105 105 105 105 105 105 2 3 0 1 0 1 0 1 2 3 2 3 2 3 2 3 2 3 0 1 0 1 0 1 105 105 
105 105 105 105 105 105 1 0 1 0 1 0 1 0 1 0 1 0 1 0 1 0 1 0 1 0 1 0 1 0 105 105 
105 105 105 105 105 105 0 1 0 1 0 1 0 1 0 1 0 1 0 1 0 1 0 1 0 1 0 1 0 1 105 105 
105 105 105 105 105 105 106 106 105 105 105 105 105 105 106 106 1 0 1 0 1 0 106 106 105 105 105 105 105 105 105 105 
105 105 105 105 105 105 2 3 2 3 2 3 2 3 2 3 0 1 0 1 0 1 2 3 2 3 2 3 2 3 105 105 
105 105 105 105 105 105 1 0 1 0 1 0 1 0 1 0 1 0 1 0 1 0 1 0 1 0 1 0 1 0 105 105 
105 105 105 105 105 105 0 1 0 1 0 1 0 1 0 1 0 1 0 1 0 1 0 1 0 1 0 1 0 1 105 105 
105 105 105 105 105 105 106 106 1 0 1 0 1 0 106 106 105 105 105 105 105 105 106 106 1 0 1 0 1 0 105 105 
2 94 95 3 2 3 2 3 0 1 0 1 0 1 2 3 2 3 2 3 2 3 2 3 0 1 0 1 0 1 105 105 
1 96 97 0 1 0 1 0 1 0 1 0 1 0 1 0 1 0 1 0 1 0 1 0 1 0 1 0 1 0 105 105 
0 1 0 1 0 1 0 1 0 1 0 1 0 1 0 1 0 1 0 1 0 1 0 1 0 1 0 1 0 1 105 105 
105 105 105 105 105 105 105 105 105 105 105 105 105 105 105 105 1 0 1 0 1 0 105 105 105 105 105 105 105 105 105 105 

19 
LADDER 96 64 3 0
LADDER 224 64 3 0
LADDER 352 64 3 0
LADDER 352 128 3 0
LADDER 352 192 3 0
LADDER 352 256 3 0
LADDER 224 256 3 0
LADDER 224 192 3 0
LADDER 224 128 3 0
LADDER 96 128 3 0
LADDER 96 192 3 0
LADDER 96 256 3 0
STONE 416 272 0
STONE 160 16 -1
KEYDOOR 64 256 1
ENEMY BAT 128 64
ENEMY BAT 160 192
ENEMY BAT 320 256
ENEMY BAT 416 192
