32 20
4 5 6 7 4 5 6 7 4 5 6 7 4 5 6 7 4 5 6 7 4 5 6 7 4 5 6 7 4 5 6 7 
8 9 10 11 8 9 10 11 8 9 10 11 8 9 10 11 8 9 10 11 8 9 10 11 8 9 10 11 8 9 10 11 
12 13 14 15 12 13 14 15 12 13 14 15 12 13 14 15 12 13 14 15 12 13 14 15 12 13 14 15 12 13 14 15 
105 105 105 105 16 17 18 19 105 105 105 105 105 105 18 19 16 17 105 105 105 105 105 105 105 105 105 105 105 105 105 105 
20 21 22 23 4 5 6 7 20 155 156 23 20 21 6 7 4 5 22 23 20 21 22 23 20 21 22 23 20 21 22 23 
8 9 10 11 8 9 10 11 8 157 158 11 8 9 10 11 8 9 10 11 8 9 10 11 8 9 10 11 8 9 10 11 
12 13 14 15 12 13 14 15 12 159 160 15 12 13 14 15 12 13 14 15 12 13 14 15 12 13 14 15 12 13 14 15 
105 105 105 105 105 105 105 105 105 105 105 105 105 105 18 19 16 17 105 105 16 17 18 19 105 105 105 105 105 105 105 105 
20 21 22 23 20 21 22 23 20 21 22 23 20 21 6 7 4 5 22 23 4 5 6 7 20 21 22 23 20 155 156 23 
8 9 10 11 8 9 10 11 8 9 10 11 8 9 10 11 8 9 10 11 8 9 10 11 8 9 10 11 8 157 158 11 
12 13 14 15 12 13 14 15 12 13 14 15 12 13 14 15 12 13 14 15 12 13 14 15 12 13 14 15 12 159 160 15 
105 105 105 105 16 17 18 19 105 105 105 105 105 105 18 19 16 17 105 105 105 105 18 19 16 17 105 105 105 105 105 105 
20 21 22 23 4 5 6 7 20 21 22 23 20 21 6 7 4 5 22 23 20 21 6 7 4 5 22 23 20 21 22 23 
8 9 10 11 8 9 10 11 8 9 10 11 8 9 10 11 8 9 10 11 8 9 10 11 8 9 10 11 8 9 10 11 
12 13 14 15 12 13 14 15 12 13 14 15 12 13 14 15 12 13 14 15 12 13 14 15 12 13 14 15 12 13 14 15 
105 105 105 105 105 105 18 19 16 17 105 105 105 105 18 19 16 17 105 105 16 17 18 19 105 105 105 105 105 105 105 105 
20 21 22 23 20 21 6 7 4 5 22 23 20 21 6 7 4 5 22 23 4 5 6 7 20 21 22 23 20 21 22 23 
8 9 10 11 8 9 10 11 8 9 10 11 8 9 10 11 8 9 10 11 8 9 10 11 8 9 10 11 8 9 10 11 
12 13 14 15 12 13 14 15 12 13 14 15 12 13 14 15 12 13 14 15 12 13 14 15 12 13 14 15 12 13 14 15 
105 105 18 19 16 17 18 19 16 17 18 19 16 17 18 19 16 17 18 19 16 17 18 19 16 17 18 19 16 17 105 105 

9 
KEYDOOR 448 64 1
STONE 112 80 0
ENEMY SKELETON 160 80
ENEMY SKELETON 288 144
ENEMY SKELETON 352 16
ENEMY BAMBU 160 144
ENEMY BAMBU 64 208
ENEMY BAMBU 64 80
ENEMY BAMBU 416 208
