32 20
105 105 105 105 105 105 105 105 105 105 105 105 105 105 105 105 4 5 6 7 4 5 6 7 4 5 6 7 4 5 6 7 
105 105 105 105 105 105 105 105 105 105 105 105 105 105 105 105 8 9 10 11 8 9 10 11 8 9 10 11 8 9 10 11 
105 105 105 105 105 105 105 105 105 105 105 105 105 105 105 105 12 13 14 15 12 13 14 15 12 13 14 15 12 13 14 15 
105 105 105 105 105 105 105 105 105 105 105 105 105 105 105 105 105 105 106 106 16 17 18 19 106 106 105 105 105 105 105 105 
105 105 105 105 105 105 105 105 105 105 105 105 105 105 105 105 20 21 22 23 4 5 6 7 20 21 22 23 105 105 105 105 
105 105 105 105 105 105 105 105 105 105 105 105 105 105 105 105 8 9 10 11 8 9 10 11 8 9 10 11 105 105 105 105 
105 105 105 105 105 105 105 105 105 105 105 105 105 105 105 105 12 13 14 15 12 13 14 15 12 13 14 15 105 105 105 105 
105 105 105 105 105 105 105 105 105 105 105 105 105 105 105 105 105 105 105 105 105 105 105 105 106 106 105 105 105 105 105 105 
105 105 105 105 20 21 22 23 20 155 156 23 20 21 22 23 20 21 22 23 20 155 156 23 20 21 22 23 105 105 105 105 
105 105 105 105 8 9 10 11 8 157 158 11 8 9 10 11 8 9 10 11 8 157 158 11 8 9 10 11 105 105 105 105 
105 105 105 105 12 13 14 15 12 159 160 15 12 13 14 15 12 13 14 15 12 159 160 15 12 13 14 15 105 105 105 105 
105 105 105 105 16 17 18 19 105 105 105 105 106 106 105 105 16 17 18 19 105 105 105 105 105 105 18 19 105 105 105 105 
105 105 105 105 4 5 6 7 20 21 22 23 20 21 22 23 4 5 6 7 20 21 22 23 20 21 6 7 105 105 105 105 
105 105 105 105 8 9 10 11 8 9 10 11 8 9 10 11 8 9 10 11 8 9 10 11 8 9 10 11 105 105 105 105 
105 105 105 105 12 13 14 15 12 13 14 15 12 13 14 15 12 13 14 15 12 13 14 15 12 13 14 15 105 105 105 105 
105 105 105 105 16 17 18 19 105 105 105 105 105 105 105 105 106 106 105 105 105 105 105 105 105 105 105 105 105 105 105 105 
105 105 105 105 4 5 6 7 20 21 22 23 20 155 156 23 20 21 22 23 20 155 156 23 20 21 22 23 20 155 156 23 
105 105 105 105 8 9 10 11 8 9 10 11 8 157 158 11 8 9 10 11 8 157 158 11 8 9 10 11 8 157 158 11 
105 105 105 105 12 13 14 15 12 13 14 15 12 159 160 15 12 13 14 15 12 159 160 15 12 13 14 15 12 159 160 15 
105 105 105 105 105 105 105 105 105 105 105 105 105 105 105 105 105 105 105 105 105 105 105 105 105 105 105 105 105 105 105 105 

13 
LADDER 192 192 3 0
LADDER 256 256 3 0
LADDER 384 128 3 0
LADDER 384 64 3 0
LADDER 288 64 3 0
STONE 352 80 -1
STONE 160 272 0
STONE 160 144 0
ENEMY KNIGHT 96 272
ENEMY KNIGHT 192 144
ENEMY KNIGHT 256 208
ENEMY KNIGHT 352 144
ENEMY KNIGHT 384 80
