32 20
105 105 105 105 105 105 105 105 105 105 105 105 105 105 105 105 105 105 105 105 105 105 105 105 105 105 105 105 105 105 105 105 
105 105 105 105 105 105 105 105 105 105 105 105 105 105 105 105 105 105 105 105 105 105 105 105 105 105 105 105 105 105 105 105 
105 105 105 105 105 105 105 105 105 105 105 105 105 105 105 105 105 105 105 105 105 105 105 105 105 105 105 105 105 105 105 105 
105 105 105 105 105 105 105 105 105 105 105 105 105 105 105 105 105 105 105 105 105 105 105 105 105 105 105 105 105 105 105 105 
105 105 2 3 2 64 65 3 2 3 2 3 2 98 98 3 2 64 65 3 2 3 2 3 2 3 2 3 2 64 65 3 
105 105 1 0 1 66 67 0 1 0 1 0 1 100 99 0 1 66 67 0 1 0 1 0 1 101 102 0 1 66 67 0 
105 105 0 1 0 68 69 1 0 1 0 1 0 1 100 1 0 68 69 1 0 1 0 1 0 103 104 1 0 68 69 1 
105 105 105 105 105 105 105 105 105 105 105 105 105 105 105 105 105 105 105 105 105 105 105 105 105 105 105 105 105 105 105 105 
105 105 105 105 105 105 105 105 2 3 2 3 2 3 2 3 2 64 65 3 2 98 98 3 2 3 2 3 2 3 2 3 
105 105 105 105 105 105 105 105 1 0 1 0 1 0 1 0 1 66 67 0 1 100 99 0 1 0 1 0 1 101 102 0 
105 105 105 105 105 105 105 105 0 1 0 1 0 1 0 1 0 68 69 1 0 1 100 1 0 1 0 1 0 103 104 1 
105 105 105 105 105 105 105 105 105 105 105 105 105 105 105 105 105 105 105 105 105 105 106 106 105 105 105 105 105 105 105 105 
2 3 2 3 2 3 2 3 2 98 98 3 2 3 2 3 2 3 2 3 2 3 2 3 2 3 2 3 2 3 2 3 
1 101 102 0 1 0 1 0 1 100 99 0 1 101 102 0 1 0 1 0 1 0 1 0 1 0 1 0 1 0 1 0 
0 103 104 1 0 1 0 1 0 1 100 1 0 103 104 1 0 1 0 1 0 1 0 1 0 1 0 1 0 1 0 1 
105 105 105 105 105 105 105 105 105 105 105 105 106 106 105 105 105 105 105 105 105 105 105 105 105 105 105 105 105 105 105 105 
105 105 2 3 2 64 65 3 2 3 2 3 2 3 2 3 2 3 2 3 2 64 65 3 2 3 2 3 2 3 105 105 
105 105 1 0 1 66 67 0 1 0 1 0 1 0 1 0 1 0 1 0 1 66 67 0 1 101 102 0 1 0 105 105 
105 105 0 1 0 68 69 1 0 1 0 1 0 1 0 1 0 1 0 1 0 68 69 1 0 103 104 1 0 1 105 105 
105 105 105 105 105 105 105 105 105 105 105 105 105 105 105 105 105 105 105 105 105 105 105 105 105 105 105 105 105 105 105 105 

8 
LADDER 192 256 3 0
LADDER 352 192 3 0
STONE 32 80 0
STONE 64 208 0
STONE 448 272 0
ENEMY LIVINGWALL 288 256 1
ENEMY LIVINGWALL 384 64 0
ENEMY LIVINGWALL 288 128 0

APPEARWALL 11 12
