32 20
105 105 105 105 36 37 38 39 36 37 38 39 36 37 38 39 36 37 38 39 36 37 38 39 36 37 38 39 36 37 105 105 
105 105 105 105 24 25 26 27 24 25 26 27 24 25 26 27 24 25 26 27 24 25 26 27 24 25 26 27 24 25 105 105 
105 105 105 105 28 29 30 31 28 29 30 31 28 29 30 31 28 29 30 31 28 29 30 31 28 29 30 31 28 29 105 105 
105 105 105 105 32 33 34 35 32 33 34 35 32 33 34 35 32 33 34 35 32 33 34 35 32 33 34 35 32 33 105 105 
105 105 105 105 36 37 38 39 36 37 38 39 36 37 38 39 36 37 38 39 36 37 38 39 36 37 38 39 36 37 42 43 
105 105 105 105 24 25 26 27 24 25 26 27 24 25 26 27 24 25 26 27 24 25 26 27 24 25 26 27 24 25 26 27 
105 105 105 105 28 29 30 31 28 29 30 31 28 29 30 31 28 29 30 31 28 29 30 31 28 29 30 31 28 29 30 31 
105 105 105 105 32 33 34 35 32 33 34 35 32 33 34 35 32 33 34 35 32 33 34 35 32 33 34 35 105 105 105 105 
105 105 105 105 36 37 38 39 36 37 38 39 36 37 38 39 36 37 38 39 36 37 38 39 36 37 38 39 105 105 105 105 
105 105 105 105 24 25 26 27 24 25 26 27 24 25 26 27 24 25 26 27 24 25 26 27 24 25 26 27 105 105 105 105 
105 105 105 105 28 29 30 31 28 29 30 31 28 29 30 31 28 29 30 31 28 29 30 31 28 29 30 31 105 105 105 105 
105 105 105 105 32 33 34 35 32 33 34 35 32 33 34 35 32 33 34 35 32 33 34 35 32 33 34 35 105 105 105 105 
105 105 105 105 36 37 38 39 36 37 38 39 36 37 38 39 36 37 38 39 36 37 38 39 36 37 38 39 105 105 105 105 
105 105 105 105 24 25 26 27 24 25 26 27 24 25 26 27 24 25 26 27 24 25 26 27 24 25 26 27 105 105 105 105 
105 105 105 105 28 29 30 31 28 29 30 31 28 29 30 31 28 29 30 31 28 29 30 31 28 29 30 31 105 105 105 105 
105 105 105 105 32 33 34 35 32 33 34 35 32 33 34 35 32 33 34 35 32 33 34 35 32 33 34 35 105 105 105 105 
105 105 105 105 36 37 38 39 36 37 38 39 36 37 38 39 36 37 38 39 36 37 38 39 36 37 38 39 105 105 105 105 
105 105 105 105 24 25 26 27 24 25 26 27 24 25 26 27 24 25 26 27 24 25 26 27 24 25 26 27 105 105 105 105 
105 105 105 105 28 29 30 31 28 29 30 31 28 29 30 31 28 29 30 31 28 29 30 31 28 29 30 31 105 105 105 105 
105 105 105 105 32 33 34 35 32 33 34 35 32 33 34 35 32 33 34 35 32 33 34 35 32 33 34 35 105 105 105 105 

2 
ENEMY BAT 384 192
ENEMY BAT 128 64

SLIME
