32 20
36 37 38 39 36 37 38 39 36 37 38 39 36 37 38 39 105 105 105 105 105 105 105 105 105 105 105 105 105 105 105 105 
24 25 26 27 24 25 26 27 24 25 26 27 24 25 26 27 105 105 105 105 105 105 105 105 105 105 105 105 105 105 105 105 
28 29 30 31 28 29 30 31 28 29 30 31 28 29 30 31 105 105 105 105 105 105 105 105 105 105 105 105 105 105 105 105 
105 105 105 105 32 33 34 35 105 105 105 105 32 33 34 35 105 105 105 105 105 105 105 105 105 105 105 105 105 105 105 105 
40 41 42 43 36 37 38 39 105 105 105 105 36 37 38 39 40 41 42 43 40 119 120 43 40 119 120 43 40 41 105 105 
24 25 26 27 24 25 26 27 105 105 105 105 24 25 26 27 24 25 26 27 24 121 122 27 24 121 122 27 24 25 105 105 
28 29 30 31 28 29 30 31 105 105 105 105 28 29 30 31 28 29 30 31 28 123 124 31 28 123 124 31 28 29 105 105 
32 33 34 35 105 105 105 105 105 105 105 105 105 105 105 105 32 33 34 35 105 105 105 105 105 105 105 105 105 105 105 105 
36 37 38 39 105 105 105 105 105 105 105 105 105 105 105 105 36 37 38 39 40 41 42 43 40 119 120 43 40 41 105 105 
24 25 26 27 105 105 105 105 105 105 105 105 105 105 105 105 24 25 26 27 24 25 26 27 24 121 122 27 24 25 105 105 
28 29 30 31 105 105 105 105 105 105 105 105 105 105 105 105 28 29 30 31 28 29 30 31 28 123 124 31 28 29 105 105 
32 33 34 35 105 105 105 105 105 105 105 105 105 105 105 105 105 105 105 105 32 33 34 35 105 105 105 105 105 105 105 105 
36 37 38 39 40 119 120 43 40 41 42 43 105 105 105 105 40 41 42 43 36 37 38 39 40 41 42 43 40 41 105 105 
24 25 26 27 24 121 122 27 24 25 26 27 105 105 105 105 24 25 26 27 24 25 26 27 24 25 26 27 24 25 105 105 
28 29 30 31 28 123 124 31 28 29 30 31 105 105 105 105 28 29 30 31 28 29 30 31 28 29 30 31 28 29 105 105 
105 105 105 105 105 105 105 105 32 33 34 35 105 105 105 105 32 33 34 35 105 105 105 105 32 33 34 35 32 33 105 105 
105 105 42 43 40 41 105 105 36 37 38 39 40 119 120 43 36 37 38 39 105 105 105 105 36 37 38 39 36 37 105 105 
105 105 26 27 24 25 105 105 24 25 26 27 24 121 122 27 24 25 26 27 105 105 105 105 24 25 26 27 24 25 105 105 
105 105 30 31 28 29 105 105 28 29 30 31 28 123 124 31 28 29 30 31 105 105 105 105 28 29 30 31 28 29 105 105 
105 105 105 105 32 33 105 105 105 105 105 105 105 105 105 105 105 105 105 105 105 105 105 105 32 33 34 35 32 33 105 105 

4 
DOOR 144 16 1
STONE 144 16 0
STONE 256 144 0
STONE 160 272 0

BUTTERFLY