32 20
105 105 105 105 48 49 50 51 48 49 50 51 48 49 50 51 105 105 105 105 48 49 50 51 48 49 50 51 48 49 50 51 
105 105 105 105 52 53 54 55 52 53 54 55 52 53 54 55 105 105 105 105 52 53 54 55 52 53 54 55 52 53 54 55 
105 105 105 105 56 57 58 59 56 57 58 59 56 57 58 59 105 105 105 105 56 57 58 59 56 57 58 59 56 57 58 59 
105 105 105 105 105 105 105 105 105 105 106 106 105 105 105 105 105 105 105 105 106 106 105 105 105 105 106 106 44 45 46 47 
105 105 105 105 60 61 62 63 60 61 62 63 60 61 62 63 60 70 71 63 60 61 62 63 60 61 62 63 48 49 50 51 
105 105 105 105 52 53 54 55 52 53 54 55 52 53 54 55 52 72 73 55 52 53 54 55 52 53 54 55 52 53 54 55 
105 105 105 105 56 57 58 59 56 57 58 59 56 57 58 59 56 74 75 59 56 57 58 59 56 57 58 59 56 57 58 59 
105 105 105 105 44 45 46 47 105 105 105 105 105 105 105 105 105 105 105 105 105 105 46 47 44 45 105 105 105 105 105 105 
105 105 105 105 48 49 50 51 60 61 62 63 60 61 62 63 60 61 62 63 60 61 50 51 48 49 62 63 60 61 62 63 
105 105 105 105 52 53 54 55 52 53 54 55 52 53 54 55 52 53 54 55 52 53 54 55 52 53 54 55 52 53 54 55 
105 105 105 105 56 57 58 59 56 57 58 59 56 57 58 59 56 57 58 59 56 57 58 59 56 57 58 59 56 57 58 59 
105 105 105 105 44 45 46 47 44 45 46 47 44 45 46 47 44 45 46 47 44 45 46 47 44 45 46 47 44 45 46 47 
105 105 105 105 163 163 163 163 163 163 163 163 163 163 163 163 163 163 163 163 163 163 163 163 163 163 163 163 163 163 163 163 
105 105 105 105 164 164 164 164 164 164 164 164 164 164 164 164 164 164 164 164 164 164 164 164 164 164 164 164 164 164 164 164 
105 105 105 105 164 164 164 164 164 164 164 164 164 164 164 164 164 164 164 164 164 164 164 164 164 164 164 164 164 164 164 164 
105 105 105 105 164 164 164 164 164 164 164 164 164 164 164 164 164 164 164 164 164 164 164 164 164 164 164 164 164 164 164 164 
105 105 105 105 164 164 164 164 164 164 164 164 164 164 164 164 164 164 164 164 164 164 164 164 164 164 164 164 164 164 164 164 
105 105 105 105 164 164 164 164 164 164 164 164 164 164 164 164 164 164 164 164 164 164 164 164 164 164 164 164 164 164 164 164 
105 105 105 105 164 164 164 164 164 164 164 164 164 164 164 164 164 164 164 164 164 164 164 164 164 164 164 164 164 164 164 164 
105 105 105 105 165 165 165 165 165 165 165 165 165 165 165 165 165 165 165 165 165 165 165 165 165 165 165 165 165 165 165 165 

7 
LADDER 160 64 3 0
LADDER 320 64 3 0
LADDER 416 64 3 0
STONE 384 16 0
STONE 128 16 30
ENEMY BAT 64 64
ENEMY BAT 256 128

LAVA
