32 20
4 5 6 7 4 5 6 7 105 105 105 105 105 105 105 105 105 105 105 105 105 105 105 105 105 105 105 105 105 105 105 105 
8 9 10 11 8 9 10 11 105 105 105 105 105 105 105 105 105 105 105 105 105 105 105 105 105 105 105 105 105 105 105 105 
12 13 14 15 12 13 14 15 105 105 105 105 105 105 105 105 105 105 105 105 105 105 105 105 105 105 105 105 105 105 105 105 
105 105 105 105 105 105 106 106 105 105 105 105 105 105 105 105 105 105 105 105 105 105 105 105 105 105 105 105 105 105 105 105 
20 21 20 21 20 21 20 21 20 21 20 21 20 21 20 21 105 105 105 105 20 21 20 21 20 155 156 21 20 21 105 105 
8 9 10 11 8 9 10 11 8 9 10 11 8 9 10 11 105 105 105 105 8 9 10 11 8 157 158 11 8 9 105 105 
12 13 14 15 12 13 14 15 12 13 14 15 12 13 14 15 105 105 105 105 12 13 14 15 12 159 160 15 12 13 105 105 
105 105 18 19 105 105 105 105 105 105 105 105 105 105 105 105 105 105 105 105 105 105 105 105 105 105 106 106 105 105 105 105 
105 105 6 7 20 155 156 21 20 21 20 21 20 21 20 21 20 21 105 105 105 105 105 105 20 21 20 21 20 21 105 105 
105 105 10 11 8 157 158 11 8 9 10 11 8 9 10 11 8 9 105 105 105 105 105 105 8 9 10 11 8 9 105 105 
105 105 14 15 12 159 160 15 12 13 14 15 12 13 14 15 12 13 105 105 105 105 105 105 12 13 14 15 12 13 105 105 
105 105 105 105 105 105 105 105 105 105 105 105 105 105 18 19 16 17 105 105 105 105 105 105 16 17 18 19 16 17 105 105 
105 105 20 21 20 21 20 21 20 155 156 21 20 21 6 7 4 5 105 105 105 105 105 105 4 5 6 7 4 5 105 105 
105 105 10 11 8 9 10 11 8 157 158 11 8 9 10 11 8 9 105 105 105 105 105 105 8 9 10 11 8 9 105 105 
105 105 14 15 12 13 14 15 12 159 160 15 12 13 14 15 12 13 105 105 105 105 105 105 12 13 14 15 12 13 105 105 
105 105 18 19 16 17 18 19 105 105 105 105 105 105 105 105 105 105 105 105 105 105 105 105 105 105 105 105 16 17 105 105 
20 21 6 7 4 5 6 7 20 21 20 21 20 155 156 21 20 21 20 21 20 21 20 21 20 155 156 21 4 5 105 105 
8 9 10 11 8 9 10 11 8 9 10 11 8 157 158 11 8 9 10 11 8 9 10 11 8 157 158 11 8 9 105 105 
12 13 14 15 12 13 14 15 12 13 14 15 12 159 160 15 12 13 14 15 12 13 14 15 12 159 160 15 12 13 105 105 
105 105 105 105 105 105 105 105 105 105 105 105 105 105 105 105 105 105 105 105 105 105 105 105 105 105 105 105 105 105 105 105 

12
LADDER 96 64 3 0
LADDER 416 128 7 0
STONE 160 144 0
STONE 352 80 -2
STONE 272 272 0
ENEMY BAT 64 192
ENEMY BAT 160 64
ENEMY BAT 224 128
ENEMY BAT 288 256
ENEMY BAMBU 128 272
ENEMY BAMBU 96 144
ENEMY BAMBU 384 80
