32 20
105 105 105 105 48 49 50 51 48 49 50 51 48 49 50 51 48 49 50 51 48 49 50 51 48 49 50 51 105 105 105 105 
105 105 105 105 52 53 54 55 52 53 54 55 52 53 54 55 52 53 54 55 52 53 54 55 52 53 54 55 105 105 105 105 
105 105 105 105 56 57 58 59 56 57 58 59 56 57 58 59 56 57 58 59 56 57 58 59 56 57 58 59 105 105 105 105 
105 105 105 105 44 45 46 47 44 45 46 47 44 45 46 47 44 45 46 47 44 45 46 47 44 45 46 47 105 105 105 105 
105 105 105 105 48 49 50 51 48 49 50 51 48 49 50 51 48 49 50 51 48 49 50 51 48 49 50 51 48 49 50 51 
105 105 105 105 52 53 54 55 52 53 54 55 52 53 54 55 52 53 54 55 52 53 54 55 52 53 54 55 52 53 54 55 
105 105 105 105 56 57 58 59 56 57 58 59 56 57 58 59 56 57 58 59 56 57 58 59 56 57 58 59 56 57 58 59 
105 105 105 105 44 45 46 47 44 45 46 47 44 45 46 47 44 45 46 47 44 45 46 47 44 45 46 47 44 45 46 47 
48 49 50 51 48 49 50 51 48 49 50 51 48 49 50 51 48 49 50 51 48 49 50 51 48 49 50 51 48 49 50 51 
52 53 54 55 52 53 54 55 52 53 54 55 52 53 54 55 52 53 54 55 52 53 54 55 52 53 54 55 52 53 54 55 
56 57 58 59 56 57 58 59 56 57 58 59 56 57 58 59 56 57 58 59 56 57 58 59 56 57 58 59 56 57 58 59 
44 45 46 47 44 45 46 47 44 45 46 47 44 45 46 47 44 45 46 47 44 45 46 47 44 45 46 47 44 45 46 47 
163 163 163 163 163 163 163 163 163 163 163 163 163 163 163 163 163 163 163 163 163 163 163 163 163 163 163 163 163 163 163 163 
164 164 164 164 164 164 164 164 164 164 164 164 164 164 164 164 164 164 164 164 164 164 164 164 164 164 164 164 164 164 164 164 
164 164 164 164 164 164 164 164 164 164 164 164 164 164 164 164 164 164 164 164 164 164 164 164 164 164 164 164 164 164 164 164 
164 164 164 164 164 164 164 164 164 164 164 164 164 164 164 164 164 164 164 164 164 164 164 164 164 164 164 164 164 164 164 164 
164 164 164 164 164 164 164 164 164 164 164 164 164 164 164 164 164 164 164 164 164 164 164 164 164 164 164 164 164 164 164 164 
164 164 164 164 164 164 164 164 164 164 164 164 164 164 164 164 164 164 164 164 164 164 164 164 164 164 164 164 164 164 164 164 
164 164 164 164 164 164 164 164 164 164 164 164 164 164 164 164 164 164 164 164 164 164 164 164 164 164 164 164 164 164 164 164 
165 165 165 165 165 165 165 165 165 165 165 165 165 165 165 165 165 165 165 165 165 165 165 165 165 165 165 165 165 165 165 165 

0 

LAVA