32 20
36 37 38 39 36 37 38 39 36 37 105 105 105 105 38 39 36 37 38 39 105 105 105 105 105 105 105 105 105 105 105 105 
24 25 26 27 24 25 26 27 24 25 105 105 105 105 26 27 24 25 26 27 105 105 105 105 105 105 105 105 105 105 105 105 
28 29 30 31 28 29 30 31 28 29 105 105 105 105 30 31 28 29 30 31 105 105 105 105 105 105 105 105 105 105 105 105 
32 33 34 35 32 33 34 35 32 33 105 105 105 105 34 35 32 33 34 35 105 105 105 105 105 105 105 105 105 105 105 105 
36 37 38 39 36 37 38 39 36 37 105 105 105 105 38 39 36 37 38 39 105 105 105 105 105 105 105 105 105 105 105 105 
24 25 26 27 24 25 26 27 24 25 105 105 105 105 26 27 24 25 26 27 105 105 105 105 105 105 105 105 105 105 105 105 
28 29 30 31 28 29 30 31 28 29 105 105 105 105 30 31 28 29 30 31 105 105 105 105 105 105 105 105 105 105 105 105 
105 105 105 105 105 105 105 105 105 105 105 105 105 105 105 105 105 105 105 105 105 105 105 105 105 105 105 105 105 105 105 105 
40 41 42 42 40 119 120 42 40 41 42 42 40 119 120 42 40 41 42 42 40 119 120 42 40 41 42 42 105 105 105 105 
24 25 26 27 24 121 122 27 24 25 26 27 24 121 122 27 24 25 26 27 24 121 122 27 24 25 26 27 105 105 105 105 
28 29 30 31 28 123 124 31 28 29 30 31 28 123 124 31 28 29 30 31 28 123 124 31 28 29 30 31 105 105 105 105 
105 105 105 105 105 105 105 105 105 105 105 105 105 105 105 105 105 105 105 105 105 105 105 105 106 106 34 35 105 105 105 105 
40 119 120 42 40 41 105 105 40 41 42 42 40 41 42 43 40 119 120 42 105 105 105 105 40 41 38 39 105 105 105 105 
24 121 122 27 24 25 105 105 24 25 26 27 24 25 26 27 24 121 122 27 105 105 105 105 24 25 26 27 105 105 105 105 
28 123 124 31 28 29 105 105 28 29 30 31 28 29 30 31 28 123 124 31 105 105 105 105 28 29 30 31 105 105 105 105 
105 105 105 105 105 105 105 105 32 33 34 35 105 105 105 105 105 105 105 105 105 105 105 105 32 33 34 35 105 105 105 105 
105 105 105 105 105 105 105 105 36 37 38 39 40 119 120 42 40 41 42 43 40 119 120 42 36 37 38 39 105 105 105 105 
105 105 105 105 105 105 105 105 24 25 26 27 24 121 122 27 24 25 26 27 24 121 122 27 24 25 26 27 105 105 105 105 
105 105 105 105 105 105 105 105 28 29 30 31 28 123 124 31 28 29 30 31 28 123 124 31 28 29 30 31 105 105 105 105 
105 105 105 105 105 105 105 105 105 105 105 105 105 105 105 105 105 105 105 105 105 105 105 105 105 105 105 105 105 105 105 105 

9 
LADDER 96 0 7 0
LADDER 256 0 7 0
LADDER 384 192 7 0
STONE 176 144 0
STONE 272 272 0
ENEMY KNIGHT 96 80
ENEMY KNIGHT 160 272
ENEMY KNIGHT 224 208
ENEMY KNIGHT 352 144
