32 20
105 105 6 7 4 5 6 7 4 5 6 7 4 5 6 7 105 105 105 105 105 105 105 105 4 5 6 7 4 5 105 105 
105 105 10 11 8 9 10 11 8 9 10 11 8 9 10 11 105 105 105 105 105 105 105 105 8 9 10 11 8 9 105 105 
105 105 14 15 12 13 14 15 12 13 14 15 12 13 14 15 105 105 105 105 105 105 105 105 12 13 14 15 12 13 105 105 
105 105 18 19 16 17 18 19 105 105 105 105 105 105 105 105 105 105 105 105 105 105 105 105 105 105 106 106 105 105 105 105 
105 105 6 7 4 5 6 7 20 21 20 21 20 21 20 21 105 105 105 105 105 105 105 105 20 21 20 21 20 21 105 105 
105 105 10 11 8 9 10 11 8 9 10 11 8 9 10 11 105 105 105 105 105 105 105 105 8 9 10 11 8 9 105 105 
105 105 14 15 12 13 14 15 12 13 14 15 12 13 14 15 105 105 105 105 105 105 105 105 12 13 14 15 12 13 105 105 
105 105 105 105 105 105 18 19 16 17 18 19 16 17 18 19 105 105 105 105 105 105 105 105 105 105 105 105 106 106 105 105 
105 105 20 21 20 21 6 7 4 5 6 7 4 5 6 7 105 105 105 105 105 105 105 105 20 21 20 21 20 21 105 105 
105 105 10 11 8 9 10 11 8 9 10 11 8 9 10 11 105 105 105 105 105 105 105 105 8 9 10 11 8 9 105 105 
105 105 14 15 12 13 14 15 12 13 14 15 12 13 14 15 105 105 105 105 105 105 105 105 12 13 14 15 12 13 105 105 
105 105 18 19 16 17 106 106 105 105 105 105 16 17 18 19 105 105 105 105 105 105 105 105 106 106 105 105 105 105 105 105 
105 105 6 7 4 5 20 21 105 105 105 105 4 5 6 7 105 105 105 105 105 105 105 105 20 21 20 21 20 21 105 105 
105 105 10 11 8 9 10 11 105 105 105 105 8 9 10 11 105 105 105 105 105 105 105 105 8 9 10 11 8 9 105 105 
105 105 14 15 12 13 14 15 105 105 105 105 12 13 14 15 105 105 105 105 105 105 105 105 12 13 14 15 12 13 105 105 
105 105 18 19 16 17 18 19 105 105 105 105 16 17 18 19 105 105 105 105 105 105 105 105 105 105 105 105 106 106 105 105 
4 5 6 7 4 5 6 7 105 105 105 105 4 5 6 7 105 105 105 105 105 105 105 105 20 21 20 21 20 21 105 105 
8 9 10 11 8 9 10 11 105 105 105 105 8 9 10 11 105 105 105 105 105 105 105 105 8 9 10 11 8 9 105 105 
12 13 14 15 12 13 14 15 105 105 105 105 12 13 14 15 105 105 105 105 105 105 105 105 12 13 14 15 12 13 105 105 
105 105 105 105 105 105 105 105 105 105 105 105 16 17 18 19 105 105 105 105 105 105 105 105 16 17 105 105 105 105 105 105 

17 
LADDER 448 256 3 0
LADDER 384 192 3 0
LADDER 448 128 3 0
LADDER 416 64 3 0
LADDER 96 192 7 0
STONE 128 144 0
STONE 160 16 0
STONE 448 16 -1
ENEMY BAT 64 128
ENEMY BAT 128 64
ENEMY BAT 224 64
ENEMY BAT 384 256
ENEMY BAMBU 128 16
ENEMY BAMBU 384 80
ENEMY BAMBU 416 208
ENEMY BAMBU 160 144
ENEMY BAMBU 384 16
