32 20
105 105 105 105 105 105 105 105 105 105 105 105 48 49 50 51 48 49 50 51 48 49 50 51 48 49 50 51 48 49 50 51 
105 105 105 105 105 105 105 105 105 105 105 105 52 53 54 55 52 53 54 55 52 53 54 55 52 53 54 55 52 53 54 55 
105 105 105 105 105 105 105 105 105 105 105 105 56 57 58 59 56 57 58 59 56 57 58 59 56 57 58 59 56 57 58 59 
105 105 105 105 105 105 105 105 105 105 105 105 105 105 105 105 105 105 106 106 44 45 46 47 44 45 46 47 105 105 105 105 
105 105 105 105 105 105 105 105 105 105 105 105 60 61 62 63 60 61 62 63 48 49 50 51 48 49 50 51 105 105 105 105 
105 105 105 105 105 105 105 105 105 105 105 105 52 53 54 55 52 53 54 55 52 53 54 55 52 53 54 55 105 105 105 105 
105 105 105 105 105 105 105 105 105 105 105 105 56 57 58 59 56 57 58 59 56 57 58 59 56 57 58 59 105 105 105 105 
105 105 105 105 105 105 105 105 105 105 105 105 44 45 46 47 105 105 105 105 44 45 105 105 105 105 105 105 105 105 105 105 
105 105 105 105 105 105 105 105 105 105 105 105 48 49 50 51 60 70 71 63 48 49 105 105 60 61 62 63 60 61 105 105 
105 105 105 105 105 105 105 105 105 105 105 105 52 53 54 55 52 72 73 55 52 53 105 105 52 53 54 55 52 53 105 105 
105 105 105 105 105 105 105 105 105 105 105 105 56 57 58 59 56 74 75 59 56 57 105 105 56 57 58 59 56 57 105 105 
105 105 105 105 105 105 105 105 105 105 105 105 105 105 105 105 105 105 105 105 105 105 105 105 44 45 46 47 44 45 105 105 
105 105 105 105 105 105 105 105 105 105 105 105 105 105 105 105 60 61 62 63 60 70 71 63 48 49 50 51 48 49 62 63 
105 105 105 105 105 105 105 105 105 105 105 105 105 105 105 105 52 53 54 55 52 72 73 55 52 53 54 55 52 53 54 55 
105 105 105 105 105 105 105 105 105 105 105 105 105 105 105 105 56 57 58 59 56 74 75 59 56 57 58 59 56 57 58 59 
105 105 105 105 105 105 105 105 105 105 105 105 105 105 105 105 105 105 105 105 105 105 105 105 44 45 46 47 44 45 105 105 
105 105 105 105 105 105 105 105 105 105 105 105 105 105 105 105 60 61 62 63 60 61 62 63 48 49 50 51 48 49 105 105 
105 105 105 105 105 105 105 105 105 105 105 105 105 105 105 105 52 53 54 55 52 53 54 55 52 53 54 55 52 53 105 105 
105 105 105 105 105 105 105 105 105 105 105 105 105 105 105 105 56 57 58 59 56 57 58 59 56 57 58 59 56 57 105 105 
105 105 105 105 105 105 105 105 105 105 105 105 105 105 105 105 44 45 46 47 105 105 105 105 105 105 105 105 44 45 105 105 

7 
LADDER 288 64 3 0
STONE 224 144 -2
ENEMY SMOKE 224 16 0
ENEMY SMOKE 320 192 1
ENEMY SMOKE 384 272 0
ENEMY SMOKE 256 144 0
ENEMY SMOKE 352 80 0
