32 20
125 125 125 125 127 128 127 128 127 128 127 128 127 128 127 128 127 128 127 128 127 128 125 125 127 128 127 128 127 128 125 125 
125 125 125 125 129 130 129 130 129 130 129 130 129 130 129 130 129 130 129 130 129 130 125 125 129 130 129 130 129 130 125 125 
125 125 125 125 128 127 128 127 128 127 128 127 128 127 128 127 128 127 128 127 128 127 125 125 128 127 128 127 128 127 125 125 
125 125 125 125 125 125 125 125 125 125 125 125 125 125 125 125 130 129 130 129 125 125 125 125 130 129 130 129 130 129 125 125 
125 125 125 125 125 125 125 125 125 125 125 125 125 125 125 125 127 128 127 128 125 125 125 125 127 128 127 128 127 128 125 125 
125 125 125 125 125 125 125 125 125 125 125 125 125 125 125 125 129 130 129 130 125 125 125 125 129 130 129 130 129 130 125 125 
125 125 125 125 125 125 125 125 125 125 125 125 125 125 125 125 128 127 128 127 125 125 125 125 128 127 128 127 128 127 125 125 
125 125 125 125 125 125 125 125 125 125 125 125 125 125 125 125 130 129 125 125 125 125 125 125 130 129 130 129 130 129 125 125 
125 125 125 125 125 125 125 125 131 132 131 132 131 135 136 132 127 128 125 125 125 125 125 125 127 128 127 128 127 128 125 125 
125 125 125 125 125 125 125 125 129 130 129 130 129 137 138 130 129 130 125 125 125 125 125 125 129 130 129 130 129 130 125 125 
125 125 125 125 125 125 125 125 128 127 128 127 128 139 140 127 128 127 125 125 125 125 125 125 128 127 128 127 128 127 125 125 
125 125 125 125 125 125 125 125 125 125 125 125 125 125 125 125 125 125 125 125 125 125 125 125 130 129 130 129 130 129 125 125 
125 125 125 125 125 125 125 125 125 125 125 125 125 125 125 125 125 125 125 125 125 125 125 125 127 128 127 128 127 128 125 125 
125 125 125 125 125 125 125 125 125 125 125 125 125 125 125 125 125 125 125 125 125 125 125 125 129 130 129 130 129 130 125 125 
125 125 125 125 125 125 125 125 125 125 125 125 125 125 125 125 125 125 125 125 125 125 125 125 128 127 128 127 128 127 125 125 
125 125 125 125 125 125 125 125 125 125 125 125 125 125 125 125 125 125 125 125 125 125 125 125 130 129 130 129 130 129 125 125 
131 132 131 132 131 135 136 132 131 132 131 132 131 132 131 132 131 132 131 132 131 132 131 132 127 128 127 128 127 128 125 125 
129 130 129 130 129 137 138 130 129 130 129 130 129 130 129 130 129 130 129 130 129 130 129 130 129 130 129 130 129 130 125 125 
128 127 128 127 128 139 140 127 128 127 128 127 128 127 128 127 128 127 128 127 128 127 128 127 128 127 128 127 128 127 125 125 
125 125 125 125 125 125 125 125 125 125 125 125 125 125 125 125 125 125 125 125 125 125 125 125 125 125 125 125 125 125 125 125 

6 
LADDER 416 0 19 0
TOMB 272 272
ENEMY BLUESPIDER 64 16
ENEMY BLUESPIDER 128 144
ENEMY BLUESPIDER 160 144
ENEMY BLUESPIDER 224 144
