32 20
127 128 127 128 127 128 127 128 127 128 127 128 127 128 127 128 125 125 125 125 127 128 127 128 127 128 127 128 127 128 125 125 
129 130 129 130 129 130 129 130 129 130 129 130 129 130 129 130 125 125 125 125 129 130 129 130 129 130 129 130 129 130 125 125 
128 127 128 127 128 127 128 127 128 127 128 127 128 127 128 127 125 125 125 125 128 127 128 127 128 127 128 127 128 127 125 125 
125 125 125 125 126 126 125 125 125 125 125 125 125 125 125 125 125 125 125 125 125 125 130 129 130 129 130 129 130 129 125 125 
125 125 131 132 131 132 131 132 131 135 136 132 131 132 131 132 131 132 131 132 125 125 127 128 127 128 127 128 127 128 125 125 
125 125 129 130 129 130 129 130 129 137 138 130 129 130 129 130 129 130 129 130 125 125 129 130 129 130 129 130 129 130 125 125 
125 125 128 127 128 127 128 127 128 139 140 127 128 127 128 127 128 127 128 127 125 125 128 127 128 127 128 127 128 127 125 125 
125 125 130 129 130 129 130 129 125 125 125 125 125 125 125 125 125 125 130 129 125 125 130 129 130 129 130 129 130 129 125 125 
125 125 127 128 127 128 127 128 131 132 131 132 131 132 131 132 131 132 127 128 125 125 127 128 127 128 127 128 127 128 125 125 
125 125 129 130 129 130 129 130 129 130 129 130 129 130 129 130 129 130 129 130 125 125 129 130 129 130 129 130 129 130 125 125 
125 125 128 127 128 127 128 127 128 127 128 127 128 127 128 127 128 127 128 127 125 125 128 127 128 127 128 127 128 127 125 125 
125 125 130 129 130 129 130 129 125 125 126 126 125 125 125 125 125 125 125 125 125 125 130 129 130 129 130 129 130 129 125 125 
125 125 127 128 127 128 127 128 131 132 131 132 131 132 131 132 131 135 136 132 125 125 127 128 127 128 127 128 127 128 125 125 
125 125 129 130 129 130 129 130 129 130 129 130 129 130 129 130 129 137 138 130 125 125 129 130 129 130 129 130 129 130 125 125 
125 125 128 127 128 127 128 127 128 127 128 127 128 127 128 127 128 139 140 127 125 125 128 127 128 127 128 127 128 127 125 125 
125 125 130 129 130 129 130 129 130 129 126 126 125 125 125 125 125 125 125 125 125 125 130 129 130 129 130 129 130 129 125 125 
125 125 127 128 127 128 127 128 127 128 131 132 131 132 131 132 131 132 131 132 125 125 127 128 127 128 127 128 127 128 125 125 
125 125 129 130 129 130 129 130 129 130 129 130 129 130 129 130 129 130 129 130 125 125 129 130 129 130 129 130 129 130 125 125 
125 125 128 127 128 127 128 127 128 127 128 127 128 127 128 127 128 127 128 127 125 125 128 127 128 127 128 127 128 127 125 125 
125 125 130 129 130 129 130 129 130 129 130 129 125 125 125 125 125 125 125 125 125 125 130 129 130 129 130 129 130 129 125 125 

8 
LADDER 416 0 21 0
LADDER 64 64 17 0
LADDER 160 192 3 0
LADDER 160 256 5 0
ENEMY BLACK 128 16
ENEMY BLACK 240 80
ENEMY BLACK 128 144
ENEMY BLACK 240 272
