32 20
127 128 127 128 127 128 127 128 127 128 127 128 127 128 127 128 127 128 127 128 127 128 127 128 127 128 127 128 127 128 127 128 
129 130 129 130 129 130 129 130 129 130 129 130 129 130 129 130 129 130 129 130 129 130 129 130 129 130 129 130 129 130 129 130 
128 127 128 127 128 127 128 127 128 127 128 127 128 127 128 127 128 127 128 127 128 127 128 127 128 127 128 127 128 127 128 127 
125 125 125 125 125 125 125 125 125 125 125 125 125 125 125 125 125 125 125 125 125 125 125 125 125 125 125 125 125 125 125 125 
131 132 131 132 131 135 136 132 131 132 131 132 131 132 131 132 131 135 136 132 131 132 131 132 131 132 131 132 131 135 136 132 
129 130 129 130 129 137 138 130 129 130 129 130 129 130 129 130 129 137 138 130 129 130 129 130 129 130 129 130 129 137 138 130 
128 127 128 127 128 139 140 127 128 127 128 127 128 127 128 127 128 139 140 127 128 127 128 127 128 127 128 127 128 139 140 127 
125 125 125 125 125 125 125 125 125 125 125 125 125 125 125 125 125 125 125 125 125 125 125 125 125 125 125 125 125 125 125 125 
131 132 131 132 131 132 131 132 131 135 136 132 131 132 131 132 131 132 131 132 131 135 136 132 131 132 131 132 131 132 125 125 
129 130 129 130 129 130 129 130 129 137 138 130 129 130 129 130 129 130 129 130 129 137 138 130 129 130 129 130 129 130 125 125 
128 127 128 127 128 127 128 127 128 139 140 127 128 127 128 127 128 127 128 127 128 139 140 127 128 127 128 127 128 127 125 125 
130 129 130 129 130 129 130 129 125 125 125 125 125 125 125 125 125 125 125 125 125 125 125 125 125 125 125 125 125 125 125 125 
127 128 127 128 127 128 127 128 131 132 131 132 131 135 136 132 131 132 131 132 131 132 131 132 131 132 131 132 131 132 125 125 
129 130 129 130 129 130 129 130 129 130 129 130 129 137 138 130 129 130 129 130 129 130 129 130 129 130 129 130 129 130 125 125 
128 127 128 127 128 127 128 127 128 127 128 127 128 139 140 127 128 127 128 127 128 127 128 127 128 127 128 127 128 127 125 125 
125 125 125 125 125 125 125 125 125 125 125 125 125 125 125 125 125 125 125 125 125 125 125 125 130 129 130 129 130 129 125 125 
125 125 125 125 125 125 125 125 125 125 125 125 125 125 125 125 125 125 125 125 125 125 125 125 127 128 127 128 127 128 131 132 
125 125 125 125 125 125 125 125 125 125 125 125 125 125 125 125 125 125 125 125 125 125 125 125 129 130 129 130 129 130 129 130 
125 125 125 125 125 125 125 125 125 125 125 125 125 125 125 125 125 125 125 125 125 125 125 125 128 127 128 127 128 127 128 127 
125 125 125 125 125 125 125 125 125 125 125 125 125 125 125 125 125 125 125 125 125 125 125 125 125 125 125 125 125 125 125 125 

6 
WNOKEYDOOR2 240 64
ENEMY WHITEBEAR 352 16
ENEMY WHITEBEAR 80 80
ENEMY WHITEBEAR 304 144
ENEMY WHITEBEAR 128 208
ENEMY WHITEBEAR 448 272
