32 20
125 125 125 125 125 125 127 128 125 125 125 125 125 125 125 128 127 125 125 125 125 125 125 125 127 128 125 125 125 125 125 125 
125 125 125 125 125 125 129 130 125 125 125 125 125 125 125 130 129 125 125 125 125 125 125 125 129 130 125 125 125 125 125 125 
125 125 125 125 125 125 128 127 125 125 125 125 125 125 125 127 128 125 125 125 125 125 125 125 128 127 125 125 125 125 125 125 
125 125 125 125 125 125 130 129 125 125 125 125 125 125 125 129 130 125 125 125 125 125 125 125 130 129 125 125 125 125 125 125 
125 125 125 125 125 125 127 128 125 125 125 125 125 125 125 128 127 125 125 125 125 125 125 125 127 128 125 125 125 125 125 125 
125 125 125 125 125 125 129 130 125 125 125 125 125 125 125 130 129 125 125 125 125 125 125 125 129 130 125 125 125 125 125 125 
125 125 125 125 125 125 128 127 125 125 125 125 125 125 125 127 128 125 125 125 125 125 125 125 128 127 125 125 125 125 125 125 
125 125 125 125 125 125 130 129 125 125 125 125 125 125 125 129 130 125 125 125 125 125 125 125 130 129 125 125 125 125 125 125 
125 125 125 125 125 125 127 128 125 125 125 125 125 125 125 128 127 125 125 125 125 125 125 125 127 128 125 125 125 125 125 125 
125 125 125 125 125 125 129 130 125 125 125 125 125 125 125 130 129 125 125 125 125 125 125 125 129 130 125 125 125 125 125 125 
125 125 125 125 125 125 128 127 125 125 125 125 125 125 125 127 128 125 125 125 125 125 125 125 128 127 125 125 125 125 125 125 
125 125 125 125 125 125 130 129 125 125 125 125 125 125 125 129 130 125 125 125 125 125 125 125 130 129 125 125 125 125 125 125 
125 125 125 125 125 125 127 128 125 125 125 125 125 125 125 128 127 125 125 125 131 132 131 132 127 128 125 125 125 125 125 125 
125 125 125 125 125 125 129 130 125 125 125 125 125 125 125 130 129 125 125 125 129 130 129 130 129 130 125 125 125 125 125 125 
125 125 125 125 125 125 128 127 125 125 125 125 125 125 125 127 128 125 125 125 128 127 128 127 128 127 125 125 125 125 125 125 
125 125 125 125 125 125 130 129 125 125 125 125 125 125 125 129 130 125 125 125 125 125 125 125 125 125 125 125 125 125 125 125 
131 135 136 132 131 132 127 128 125 125 125 125 125 125 125 128 127 125 125 125 125 125 125 125 125 125 125 125 125 125 125 125 
129 137 138 130 129 130 129 130 125 125 125 125 125 125 125 130 129 125 125 125 125 125 125 125 125 125 125 125 125 125 125 125 
128 139 140 127 128 127 128 127 125 125 125 125 125 125 125 127 128 125 125 125 125 125 125 125 125 125 125 125 125 125 125 125 
125 125 125 125 125 125 125 125 125 125 125 125 125 125 125 129 130 125 125 125 125 125 125 125 125 125 125 125 125 125 125 125 

10 
LADDER 384 0 15 0
LADDER 240 0 21 0
LADDER 96 0 19 0
WITEM 320 208 0
HITWALL 320 192 32
ENEMY CLOUD 224 128
ENEMY CLOUD 304 176
ENEMY CLOUD 320 192
ENEMY CLOUD 352 96
ENEMY CLOUD 368 112
