32 20
125 125 127 128 127 128 127 128 127 128 127 128 127 128 127 128 127 128 127 128 127 128 127 128 127 128 127 128 127 128 125 125 
125 125 129 130 129 130 129 130 129 130 129 130 129 130 129 130 129 130 129 130 129 130 129 130 129 130 129 130 129 130 125 125 
125 125 128 127 128 127 128 127 128 127 128 127 128 127 128 127 128 127 128 127 128 127 128 127 128 127 128 127 128 127 125 125 
125 125 130 129 130 129 130 129 125 125 130 129 130 129 130 129 125 125 130 129 130 129 130 129 130 129 130 129 130 129 125 125 
125 125 127 128 127 128 127 128 131 132 127 128 127 128 127 128 131 132 127 128 127 128 127 128 127 128 127 128 127 128 131 132 
125 125 129 130 129 130 129 130 129 130 129 130 129 130 129 130 129 130 129 130 129 130 129 130 129 130 129 130 129 130 129 130 
125 125 128 127 128 127 128 127 128 127 128 127 128 127 128 127 128 127 128 127 128 127 128 127 128 127 128 127 128 127 128 127 
125 125 125 125 125 125 125 125 126 126 125 125 125 125 125 125 125 125 125 125 125 125 125 125 125 125 125 125 125 125 125 125 
125 125 131 132 131 135 136 132 131 132 131 132 131 132 131 132 131 132 131 132 131 132 131 132 131 135 136 132 131 132 131 132 
125 125 129 130 129 137 138 130 129 130 129 130 129 130 129 130 129 130 129 130 129 130 129 130 129 137 138 130 129 130 129 130 
125 125 128 127 128 139 140 127 128 127 128 127 128 127 128 127 128 127 128 127 128 127 128 127 128 139 140 127 128 127 128 127 
125 125 125 125 125 125 125 125 125 125 125 125 125 125 125 125 130 129 130 129 125 125 125 125 125 125 125 125 125 125 125 125 
125 125 131 132 131 132 131 132 131 132 131 132 131 135 136 132 127 128 127 128 131 132 131 132 131 132 125 125 125 125 125 125 
125 125 129 130 129 130 129 130 129 130 129 130 129 137 138 130 129 130 129 130 129 130 129 130 129 130 125 125 125 125 125 125 
125 125 128 127 128 127 128 127 128 127 128 127 128 139 140 127 128 127 128 127 128 127 128 127 128 127 125 125 125 125 125 125 
125 125 125 125 125 125 125 125 130 129 130 129 125 126 126 125 125 125 125 126 126 125 125 125 125 125 125 125 125 125 125 125 
125 125 131 132 131 135 136 132 127 128 127 128 131 132 131 132 131 132 131 132 131 132 131 132 131 132 131 132 131 135 136 132 
125 125 129 130 129 137 138 130 129 130 129 130 129 130 129 130 129 130 129 130 129 130 129 130 129 130 129 130 129 137 138 130 
125 125 128 127 128 139 140 127 128 127 128 127 128 127 128 127 128 127 128 127 128 127 128 127 128 127 128 127 128 139 140 127 
125 125 125 125 125 125 125 125 125 125 125 125 130 129 130 129 125 125 125 125 125 125 125 125 130 129 130 129 125 125 125 125 

9 
LADDER 128 128 3 0
LADDER 208 256 5 0
LADDER 304 256 3 0
TOMB 80 208
ENEMY WORM2 64 80
ENEMY WORM2 192 144
ENEMY WORM2 288 80
ENEMY WORM2 384 208
ENEMY WORM2 128 272
