32 20
127 128 127 128 127 128 127 128 127 128 127 128 127 128 127 128 125 125 125 125 125 125 125 125 127 128 127 128 127 128 125 125 
129 130 129 130 129 130 129 130 129 130 129 130 129 130 129 130 125 125 125 125 125 125 125 125 129 130 129 130 129 130 125 125 
128 127 128 127 128 127 128 127 128 127 128 127 128 127 128 127 125 125 125 125 125 125 125 125 128 127 128 127 128 127 125 125 
125 125 125 125 130 129 130 129 125 125 125 125 130 129 130 129 125 125 125 125 125 125 125 125 125 126 126 125 125 125 125 125 
131 135 136 132 127 128 127 128 131 132 131 132 127 128 127 128 125 125 125 125 125 125 125 125 131 132 131 132 131 132 125 125 
129 137 138 130 129 130 129 130 129 130 129 130 129 130 129 130 125 125 125 125 125 125 125 125 129 130 129 130 129 130 125 125 
128 139 140 127 128 127 128 127 128 127 128 127 128 127 128 127 125 125 125 125 125 125 125 125 128 127 128 127 128 127 125 125 
125 125 125 125 130 129 130 129 130 129 130 129 125 125 125 125 125 125 125 125 125 125 125 125 130 129 130 129 130 129 125 125 
131 132 131 132 127 128 127 128 127 128 127 128 131 132 131 132 125 125 125 125 125 125 125 125 127 128 127 128 127 128 125 125 
129 130 129 130 129 130 129 130 129 130 129 130 129 130 129 130 125 125 125 125 125 125 125 125 129 130 129 130 129 130 125 125 
128 127 128 127 128 127 128 127 128 127 128 127 128 127 128 127 125 125 125 125 125 125 125 125 128 127 128 127 128 127 125 125 
125 125 125 125 130 129 130 129 125 125 125 125 130 129 130 129 125 125 125 125 125 125 125 125 126 126 125 125 125 125 125 125 
131 135 136 132 127 128 127 128 131 132 131 132 127 128 127 128 125 125 125 125 125 125 125 125 131 132 131 132 131 132 125 125 
129 137 138 130 129 130 129 130 129 130 129 130 129 130 129 130 125 125 125 125 125 125 125 125 129 130 129 130 129 130 125 125 
128 139 140 127 128 127 128 127 128 127 128 127 128 127 128 127 125 125 125 125 125 125 125 125 128 127 128 127 128 127 125 125 
125 125 125 125 130 129 130 129 130 129 130 129 125 125 125 125 125 125 125 125 125 125 125 125 130 129 130 129 130 129 125 125 
131 132 131 132 127 128 127 128 127 128 127 128 131 132 131 132 125 125 125 125 125 125 125 125 127 128 127 128 127 128 125 125 
129 130 129 130 129 130 129 130 129 130 129 130 129 130 129 130 125 125 125 125 125 125 125 125 129 130 129 130 129 130 125 125 
128 127 128 127 128 127 128 127 128 127 128 127 128 127 128 127 125 125 125 125 125 125 125 125 128 127 128 127 128 127 125 125 
125 125 125 125 130 129 130 129 125 125 125 125 130 129 130 129 125 125 125 125 125 125 125 125 130 129 130 129 130 129 125 125 

8 
LADDER 400 64 7 0
LADDER 384 192 9 0
ENEMY WORM2 384 144
ENEMY WORM2 160 144
ENEMY WORM2 128 16
ENEMY WORM2 32 80
ENEMY WORM2 32 208
WITEM 384 16 1
