32 20
125 125 127 128 127 128 127 128 127 128 127 128 127 128 127 128 125 125 125 125 125 125 125 125 127 128 127 128 127 128 125 125 
125 125 129 130 129 130 129 130 129 130 129 130 129 130 129 130 125 125 125 125 125 125 125 125 129 130 129 130 129 130 125 125 
125 125 128 127 128 127 128 127 128 127 128 127 128 127 128 127 125 125 125 125 125 125 125 125 128 127 128 127 128 127 125 125 
125 125 125 125 126 126 125 125 125 125 125 125 130 129 130 129 125 125 125 125 125 125 125 125 125 125 125 125 130 129 125 125 
125 125 131 132 131 132 131 132 131 132 131 132 127 128 127 128 125 125 125 125 125 125 125 125 131 132 131 132 127 128 125 125 
125 125 129 130 129 130 129 130 129 130 129 130 129 130 129 130 125 125 125 125 125 125 125 125 129 130 129 130 129 130 125 125 
125 125 128 127 128 127 128 127 128 127 128 127 128 127 128 127 125 125 125 125 125 125 125 125 128 127 128 127 128 127 125 125 
125 125 125 125 125 125 125 125 125 125 125 125 130 129 130 129 125 125 125 125 125 125 125 125 130 129 125 125 125 125 125 125 
125 125 131 132 131 132 131 132 131 132 131 132 127 128 127 128 131 132 131 132 131 132 131 132 127 128 131 132 131 132 125 125 
125 125 129 130 129 130 129 130 129 130 129 130 129 130 129 130 129 130 129 130 129 130 129 130 129 130 129 130 129 130 125 125 
125 125 128 127 128 127 128 127 128 127 128 127 128 127 128 127 128 127 128 127 128 127 128 127 128 127 128 127 128 127 125 125 
125 125 130 129 130 129 130 129 130 129 130 129 130 129 130 129 125 125 125 125 125 125 125 125 126 126 125 125 125 125 125 125 
125 125 127 128 127 128 127 128 127 128 127 128 127 128 127 128 125 125 125 125 125 125 125 125 131 132 131 132 131 132 125 125 
125 125 129 130 129 130 129 130 129 130 129 130 129 130 129 130 125 125 125 125 125 125 125 125 129 130 129 130 129 130 125 125 
125 125 128 127 128 127 128 127 128 127 128 127 128 127 128 127 125 125 125 125 125 125 125 125 128 127 128 127 128 127 125 125 
125 125 126 126 125 125 125 125 125 125 125 125 130 129 130 129 125 125 125 125 125 125 125 125 130 129 130 129 130 129 125 125 
125 125 131 132 131 132 131 132 131 135 136 132 127 128 127 128 125 125 125 125 125 125 125 125 127 128 127 128 127 128 125 125 
125 125 129 130 129 130 129 130 129 137 138 130 129 130 129 130 125 125 125 125 125 125 125 125 129 130 129 130 129 130 125 125 
125 125 128 127 128 127 128 127 128 139 140 127 128 127 128 127 125 125 125 125 125 125 125 125 128 127 128 127 128 127 125 125 
125 125 130 129 130 129 130 129 125 125 125 125 125 125 125 125 125 125 125 125 125 125 125 125 130 129 130 129 130 129 125 125 

8 
LADDER 160 0 3 0
LADDER 64 64 3 0
LADDER 384 0 3 0
LADDER 384 192 9 0
LADDER 32 256 5 0
TOMB 144 80
WKEYDOOR 304 128 1
ENEMY HAIRY 256 160
