32 20
125 125 127 128 127 128 127 128 127 128 127 128 127 128 127 128 127 128 127 128 127 128 127 128 127 128 127 128 127 128 125 125 
125 125 129 130 129 130 129 130 129 130 129 130 129 130 129 130 129 130 129 130 129 130 129 130 129 130 129 130 129 130 125 125 
125 125 128 127 128 127 128 127 128 127 128 127 128 127 128 127 128 127 128 127 128 127 128 127 128 127 128 127 128 127 125 125 
125 125 125 125 125 125 126 126 130 129 130 129 126 126 125 125 125 125 126 126 130 129 130 129 126 126 125 125 125 125 125 125 
125 125 131 132 131 132 131 132 127 128 127 128 131 132 131 132 131 132 131 132 127 128 127 128 131 132 131 132 131 132 125 125 
125 125 129 130 129 130 129 130 129 130 129 130 129 130 129 130 129 130 129 130 129 130 129 130 129 130 129 130 129 130 125 125 
125 125 128 127 128 127 128 127 128 127 128 127 128 127 128 127 128 127 128 127 128 127 128 127 128 127 128 127 128 127 125 125 
125 125 130 129 130 129 126 126 125 125 125 125 126 126 130 129 130 129 126 126 125 125 125 125 126 126 130 129 130 129 125 125 
125 125 127 128 127 128 131 132 131 132 131 132 131 132 127 128 127 128 131 132 131 132 131 132 131 132 127 128 127 128 125 125 
125 125 129 130 129 130 129 130 129 130 129 130 129 130 129 130 129 130 129 130 129 130 129 130 129 130 129 130 129 130 125 125 
125 125 128 127 128 127 128 127 128 127 128 127 128 127 128 127 128 127 128 127 128 127 128 127 128 127 128 127 128 127 125 125 
125 125 125 125 125 125 126 126 130 129 130 129 126 126 125 125 125 125 126 126 130 129 130 129 126 126 125 125 125 125 125 125 
125 125 131 132 131 132 131 132 127 128 127 128 131 132 131 132 131 132 131 132 127 128 127 128 131 132 131 132 131 132 125 125 
125 125 129 130 129 130 129 130 129 130 129 130 129 130 129 130 129 130 129 130 129 130 129 130 129 130 129 130 129 130 125 125 
125 125 128 127 128 127 128 127 128 127 128 127 128 127 128 127 128 127 128 127 128 127 128 127 128 127 128 127 128 127 125 125 
125 125 130 129 130 129 126 126 125 125 125 125 126 126 130 129 130 129 126 126 125 125 125 125 126 126 130 129 130 129 125 125 
125 125 127 128 127 128 131 132 131 132 131 132 131 132 127 128 127 128 131 132 131 132 131 132 131 132 127 128 127 128 131 132 
125 125 129 130 129 130 129 130 129 130 129 130 129 130 129 130 129 130 129 130 129 130 129 130 129 130 129 130 129 130 129 130 
125 125 128 127 128 127 128 127 128 127 128 127 128 127 128 127 128 127 128 127 128 127 128 127 128 127 128 127 128 127 128 127 
125 125 125 125 125 125 125 125 125 125 125 125 125 125 125 125 125 125 125 125 125 125 125 125 125 125 125 125 125 125 125 125 

29 
LADDER 384 0 3 0
LADDER 384 64 3 0
LADDER 384 128 3 0
LADDER 384 192 3 0
LADDER 384 256 3 0
LADDER 288 256 3 0
LADDER 288 192 3 0
LADDER 288 128 3 0
LADDER 288 64 3 0
LADDER 288 0 3 0
LADDER 192 0 3 0
LADDER 192 64 3 0
LADDER 192 128 3 0
LADDER 192 192 3 0
LADDER 192 256 3 0
LADDER 96 256 3 0
LADDER 96 192 3 0
LADDER 96 128 3 0
LADDER 96 64 3 0
LADDER 96 0 3 0
ENEMY BAT 256 64
ENEMY BAT 128 128
ENEMY BAT 32 192
TOMB 144 272
ENEMY BAT 128 256
ENEMY BAT 256 192
ENEMY BAT 320 256
ENEMY BAT 448 192
ENEMY BAT 352 128
