32 20
125 125 125 125 127 128 127 128 127 128 127 128 127 128 127 128 127 128 127 128 127 128 127 128 127 128 125 125 125 125 125 125 
125 125 125 125 129 130 129 130 129 130 129 130 129 130 129 130 129 130 129 130 129 130 129 130 129 130 125 125 125 125 125 125 
125 125 125 125 128 127 128 127 128 127 128 127 128 127 128 127 128 127 128 127 128 127 128 127 128 127 125 125 125 125 125 125 
125 125 125 125 126 126 125 125 125 125 125 125 125 125 130 129 130 129 125 125 125 125 125 125 125 125 125 125 125 125 125 125 
125 125 125 125 131 132 131 132 131 135 136 132 131 132 127 128 127 128 131 132 131 135 136 132 131 132 131 132 125 125 125 125 
125 125 125 125 129 130 129 130 129 137 138 130 129 130 129 130 129 130 129 130 129 137 138 130 129 130 129 130 125 125 125 125 
125 125 125 125 128 127 128 127 128 139 140 127 128 127 128 127 128 127 128 127 128 139 140 127 128 127 128 127 125 125 125 125 
125 125 125 125 125 125 125 125 125 125 125 125 125 125 130 129 130 129 125 125 125 125 125 125 125 125 126 126 125 125 125 125 
125 125 125 125 131 132 131 132 131 132 131 132 131 132 127 128 127 128 131 132 131 132 131 132 131 132 131 132 125 125 125 125 
125 125 125 125 129 130 129 130 129 130 129 130 129 130 129 130 129 130 129 130 129 130 129 130 129 130 129 130 125 125 125 125 
125 125 125 125 128 127 128 127 128 127 128 127 128 127 128 127 128 127 128 127 128 127 128 127 128 127 128 127 125 125 125 125 
125 125 125 125 126 126 125 125 125 125 125 125 125 125 130 129 130 129 125 125 125 125 125 125 125 125 125 125 125 125 125 125 
125 125 125 125 131 132 131 132 131 135 136 132 131 132 127 128 127 128 131 132 131 135 136 132 131 132 131 132 125 125 125 125 
125 125 125 125 129 130 129 130 129 137 138 130 129 130 129 130 129 130 129 130 129 137 138 130 129 130 129 130 125 125 125 125 
125 125 125 125 128 127 128 127 128 139 140 127 128 127 128 127 128 127 128 127 128 139 140 127 128 127 128 127 125 125 125 125 
125 125 125 125 125 125 125 125 125 125 125 125 125 125 130 129 130 129 125 125 125 125 125 125 125 125 126 126 125 125 125 125 
125 125 125 125 131 132 131 132 131 132 131 132 131 132 127 128 127 128 131 132 131 132 131 132 131 132 131 132 125 125 125 125 
125 125 125 125 129 130 129 130 129 130 129 130 129 130 129 130 129 130 129 130 129 130 129 130 129 130 129 130 125 125 125 125 
125 125 125 125 128 127 128 127 128 127 128 127 128 127 128 127 128 127 128 127 128 127 128 127 128 127 128 127 125 125 125 125 
125 125 125 125 125 125 125 125 125 125 125 125 125 125 130 129 130 129 125 125 125 125 125 125 130 129 130 129 125 125 125 125 

6 
LADDER 384 0 3 0
LADDER 64 64 3 0
LADDER 64 192 3 0
LADDER 416 128 3 0
LADDER 416 256 5 0
TOMB 144 272

ROLLINGSTONES