32 20
125 125 125 125 125 125 125 125 125 125 125 125 125 125 127 128 127 128 125 125 125 125 127 128 125 125 125 125 125 125 125 125 
125 125 125 125 125 125 125 125 125 125 125 125 125 125 129 130 129 130 125 125 125 125 129 130 125 125 125 125 125 125 125 125 
125 125 125 125 125 125 125 125 125 125 125 125 125 125 128 127 128 127 125 125 125 125 128 127 125 125 125 125 125 125 125 125 
125 125 125 125 125 125 125 125 125 125 125 125 125 125 130 129 130 129 125 125 125 125 126 126 125 125 125 125 125 125 125 125 
125 125 125 125 131 132 131 132 131 132 131 132 131 132 127 128 127 128 131 132 131 132 131 132 131 135 136 132 125 125 125 125 
125 125 125 125 129 130 129 130 129 130 129 130 129 130 129 130 129 130 129 130 129 130 129 130 129 137 138 130 125 125 125 125 
125 125 125 125 128 127 128 127 128 127 128 127 128 127 128 127 128 127 128 127 128 127 128 127 128 139 140 127 125 125 125 125 
125 125 125 125 130 129 130 129 125 125 125 125 126 126 130 129 130 129 125 125 125 125 125 125 125 125 125 125 125 125 125 125 
125 125 125 125 127 128 127 128 131 132 131 132 131 132 127 128 127 128 131 132 131 132 131 132 125 125 125 125 125 125 125 125 
125 125 125 125 129 130 129 130 129 130 129 130 129 130 129 130 129 130 129 130 129 130 129 130 125 125 125 125 125 125 125 125 
125 125 125 125 128 127 128 127 128 127 128 127 128 127 128 127 128 127 128 127 128 127 128 127 125 125 125 125 125 125 125 125 
125 125 125 125 130 129 130 129 125 125 126 126 125 125 130 129 130 129 130 129 130 129 130 129 125 125 125 125 125 125 125 125 
125 125 125 125 127 128 127 128 131 132 131 132 131 132 127 128 127 128 127 128 127 128 127 128 125 125 125 125 125 125 125 125 
125 125 125 125 129 130 129 130 129 130 129 130 129 130 129 130 129 130 129 130 129 130 129 130 125 125 125 125 125 125 125 125 
125 125 125 125 128 127 128 127 128 127 128 127 128 127 128 127 128 127 128 127 128 127 128 127 125 125 125 125 125 125 125 125 
125 125 125 125 130 129 126 126 125 125 125 125 130 129 130 129 125 125 130 129 130 129 130 129 125 125 125 125 125 125 125 125 
125 125 125 125 127 128 131 132 131 132 131 132 127 128 127 128 131 132 127 128 127 128 127 128 125 125 125 125 125 125 125 125 
125 125 125 125 129 130 129 130 129 130 129 130 129 130 129 130 129 130 129 130 129 130 129 130 125 125 125 125 125 125 125 125 
125 125 125 125 128 127 128 127 128 127 128 127 128 127 128 127 128 127 128 127 128 127 128 127 125 125 125 125 125 125 125 125 
125 125 125 125 130 129 130 129 130 129 130 129 130 129 130 129 130 129 125 125 125 125 125 125 125 125 125 125 125 125 125 125 

11 
LADDER 352 0 3 0
LADDER 352 64 3 0
LADDER 192 128 3 0
LADDER 160 192 3 0
LADDER 96 256 5 0
TOMB 144 80
ENEMY FLAME 128 80
ENEMY FLAME 128 144
ENEMY FLAME 96 208
ENEMY FLAME 288 80
ENEMY FLAME 320 272
