32 20
125 125 125 125 125 125 127 128 127 128 127 128 127 128 127 128 127 128 127 128 127 128 127 128 127 128 125 125 125 125 125 125 
125 125 125 125 125 125 129 130 129 130 129 130 129 130 129 130 129 130 129 130 129 130 129 130 129 130 125 125 125 125 125 125 
125 125 125 125 125 125 128 127 128 127 128 127 128 127 128 127 128 127 128 127 128 127 128 127 128 127 125 125 125 125 125 125 
125 125 125 125 125 125 125 125 125 125 130 129 130 129 125 125 125 125 130 129 130 129 130 129 130 129 125 125 125 125 125 125 
125 125 125 125 125 125 131 132 131 132 127 128 127 128 131 132 131 132 127 128 127 128 127 128 127 128 125 125 125 125 125 125 
125 125 125 125 125 125 129 130 129 130 129 130 129 130 129 130 129 130 129 130 129 130 129 130 129 130 125 125 125 125 125 125 
125 125 125 125 125 125 128 127 128 127 128 127 128 127 128 127 128 127 128 127 128 127 128 127 128 127 125 125 125 125 125 125 
125 125 125 125 125 125 130 129 130 129 130 129 130 129 125 125 125 125 130 129 130 129 130 129 130 129 125 125 125 125 125 125 
125 125 125 125 125 125 127 128 127 128 127 128 127 128 131 132 131 132 127 128 127 128 127 128 127 128 125 125 125 125 125 125 
125 125 125 125 125 125 129 130 129 130 129 130 129 130 129 130 129 130 129 130 129 130 129 130 129 130 125 125 125 125 125 125 
125 125 125 125 125 125 128 127 128 127 128 127 128 127 128 127 128 127 128 127 128 127 128 127 128 127 125 125 125 125 125 125 
125 125 125 125 125 125 125 125 126 126 130 129 130 129 130 129 130 129 130 129 130 129 130 129 130 129 125 125 125 125 125 125 
125 125 125 125 125 125 131 132 131 132 127 128 127 128 127 128 127 128 127 128 127 128 127 128 127 128 125 125 125 125 125 125 
125 125 125 125 125 125 129 130 129 130 129 130 129 130 129 130 129 130 129 130 129 130 129 130 129 130 125 125 125 125 125 125 
125 125 125 125 125 125 128 127 128 127 128 127 128 127 128 127 128 127 128 127 128 127 128 127 128 127 125 125 125 125 125 125 
125 125 125 125 125 125 130 129 125 125 130 129 130 129 130 129 125 125 125 125 130 129 130 129 130 129 125 125 125 125 125 125 
125 125 125 125 125 125 127 128 131 132 127 128 127 128 127 128 131 132 131 132 127 128 127 128 127 128 125 125 125 125 125 125 
125 125 125 125 125 125 129 130 129 130 129 130 129 130 129 130 129 130 129 130 129 130 129 130 129 130 125 125 125 125 125 125 
125 125 125 125 125 125 128 127 128 127 128 127 128 127 128 127 128 127 128 127 128 127 128 127 128 127 125 125 125 125 125 125 
125 125 125 125 125 125 130 129 130 129 130 129 130 129 125 125 125 125 130 129 130 129 130 129 130 129 125 125 125 125 125 125 

10 
LADDER 128 192 3 0
LADDER 256 0 3 0
ENEMY BAT 224 64
ENEMY BAT 256 128
ENEMY BAT 256 128
ENEMY BAT 256 128
ENEMY BAT 256 128
ENEMY BAT 224 64
ENEMY BAT 224 64
ENEMY BAT 224 64
