32 20
125 125 125 125 125 125 127 128 127 128 127 128 127 128 127 128 127 128 127 128 127 128 127 128 127 128 125 125 125 125 125 125 
125 125 125 125 125 125 129 130 129 130 129 130 129 130 129 130 129 130 129 130 129 130 129 130 129 130 125 125 125 125 125 125 
125 125 125 125 125 125 128 127 128 127 128 127 128 127 128 127 128 127 128 127 128 127 128 127 128 127 125 125 125 125 125 125 
125 125 125 125 125 125 130 129 130 129 130 129 130 129 130 129 126 126 125 125 126 126 130 129 130 129 125 125 125 125 125 125 
125 125 125 125 125 125 127 128 127 128 127 128 127 128 127 128 127 128 127 128 127 128 127 128 127 128 125 125 125 125 125 125 
125 125 125 125 125 125 129 130 129 130 129 130 129 130 129 130 129 130 129 130 129 130 129 130 129 130 125 125 125 125 125 125 
125 125 125 125 125 125 128 127 128 127 128 127 128 127 128 127 128 127 128 127 128 127 128 127 128 127 125 125 125 125 125 125 
125 125 125 125 125 125 130 129 130 129 130 129 130 129 125 125 125 125 125 125 125 125 130 129 130 129 125 125 125 125 125 125 
125 125 125 125 125 125 127 128 127 128 127 128 127 128 127 128 127 135 136 128 127 128 127 128 127 128 125 125 125 125 125 125 
125 125 125 125 125 125 129 130 129 130 129 130 129 130 129 130 129 137 138 130 129 130 129 130 129 130 125 125 125 125 125 125 
125 125 125 125 125 125 128 127 128 127 128 127 128 127 128 127 128 139 140 127 128 127 128 127 128 127 125 125 125 125 125 125 
125 125 125 125 125 125 125 125 125 125 130 129 130 129 125 125 125 125 125 125 126 126 130 129 130 129 125 125 125 125 125 125 
125 125 125 125 125 125 127 128 127 128 127 128 127 128 127 128 127 128 127 128 127 128 127 128 127 128 125 125 125 125 125 125 
125 125 125 125 125 125 129 130 129 130 129 130 129 130 129 130 129 130 129 130 129 130 129 130 129 130 125 125 125 125 125 125 
125 125 125 125 125 125 128 127 128 127 128 127 128 127 128 127 128 127 128 127 128 127 128 127 128 127 125 125 125 125 125 125 
125 125 125 125 125 125 130 129 130 129 130 129 130 129 125 125 126 126 125 125 125 125 130 129 130 129 125 125 125 125 125 125 
125 125 125 125 125 125 127 128 127 128 127 128 127 128 127 128 127 128 127 128 127 128 127 128 127 128 125 125 125 125 125 125 
125 125 125 125 125 125 129 130 129 130 129 130 129 130 129 130 129 130 129 130 129 130 129 130 129 130 125 125 125 125 125 125 
125 125 125 125 125 125 128 127 128 127 128 127 128 127 128 127 128 127 128 127 128 127 128 127 128 127 125 125 125 125 125 125 
125 125 125 125 125 125 130 129 130 129 130 129 130 129 130 129 125 125 125 125 130 129 130 129 130 129 125 125 125 125 125 125 

11 
LADDER 256 0 3 0
LADDER 320 0 3 0
LADDER 320 64 3 0
LADDER 256 64 3 0
LADDER 320 192 3 0
LADDER 256 256 3 0
TOMB 272 208
WKEYDOOR 256 128 1
ENEMY SNAKE 320 208
ENEMY SNAKE 288 80
ENEMY SNAKE 96 144
