32 20
4 5 6 7 4 5 6 7 4 5 6 7 4 5 6 7 4 5 6 7 4 5 6 7 4 5 6 7 4 5 6 7 
8 9 10 11 8 9 10 11 8 9 10 11 8 9 10 11 8 9 10 11 8 9 10 11 8 9 10 11 8 9 10 11 
12 13 14 15 12 13 14 15 12 13 14 15 12 13 14 15 12 13 14 15 12 13 14 15 12 13 14 15 12 13 14 15 
105 105 105 105 105 105 105 105 105 105 105 105 105 105 105 105 105 105 105 105 105 105 105 105 105 105 105 105 105 105 105 105 
105 105 105 105 105 105 105 105 105 105 105 105 105 105 105 105 105 105 105 105 105 105 105 105 105 105 105 105 105 105 105 105 
105 105 105 105 105 105 105 105 105 105 105 105 105 105 105 105 105 105 105 105 105 105 105 105 105 105 105 105 105 105 105 105 
105 105 105 105 105 105 105 105 105 105 105 105 105 105 105 105 105 105 105 105 105 105 105 105 105 105 105 105 105 105 105 105 
105 105 105 105 105 105 105 105 105 105 105 105 105 105 105 105 105 105 105 105 105 105 105 105 105 105 105 105 105 105 105 105 
105 105 105 105 105 105 105 105 105 105 105 105 105 105 105 105 105 105 105 105 105 105 105 105 105 105 105 105 105 105 105 105 
105 105 105 105 105 105 105 105 105 105 105 105 105 105 105 105 105 105 105 105 105 105 105 105 105 105 105 105 105 105 105 105 
105 105 105 105 105 105 105 105 105 105 105 105 105 105 105 105 105 105 105 105 105 105 105 105 105 105 105 105 105 105 105 105 
105 105 105 105 105 105 105 105 105 105 105 105 105 105 105 105 105 105 105 105 105 105 105 105 105 105 105 105 105 105 105 105 
105 105 105 105 105 105 105 105 20 21 20 21 20 21 20 21 20 21 20 21 20 155 156 21 20 21 20 21 20 21 20 21 
105 105 105 105 105 105 105 105 8 9 10 11 8 9 10 11 8 9 10 11 8 157 158 11 8 9 10 11 8 9 10 11 
105 105 105 105 105 105 105 105 12 13 14 15 12 13 14 15 12 13 14 15 12 159 160 15 12 13 14 15 12 13 14 15 
105 105 105 105 105 105 105 105 16 17 18 19 105 105 105 105 105 105 105 105 105 105 105 105 105 105 105 105 105 105 105 105 
105 105 105 105 105 105 105 105 4 5 6 7 20 155 156 21 20 21 20 21 105 105 105 105 20 21 20 21 20 155 156 21 
105 105 105 105 105 105 105 105 8 9 10 11 8 157 158 11 8 9 10 11 105 105 105 105 8 9 10 11 8 157 158 11 
105 105 105 105 105 105 105 105 12 13 14 15 12 159 160 15 12 13 14 15 105 105 105 105 12 13 14 15 12 159 160 15 
105 105 105 105 105 105 105 105 105 105 105 105 105 105 105 105 16 17 18 19 105 105 105 105 16 17 105 105 105 105 105 105 

8 
KEYDOOR 256 0 1
STONE 160 16 0
STONE 256 208 -1
STONE 384 208 0
ENEMY BAT 224 256
ENEMY BAT 288 192
ENEMY BAT 96 64
ENEMY BAT 384 96

APPEARWALL 19 12
