32 20
4 5 6 7 4 5 6 7 4 5 6 7 105 105 105 105 4 5 6 7 4 5 6 7 4 5 6 7 4 5 105 105 
8 9 10 11 8 9 10 11 8 9 10 11 105 105 105 105 8 9 10 11 8 9 10 11 8 9 10 11 8 9 105 105 
12 13 14 15 12 13 14 15 12 13 14 15 105 105 105 105 12 13 14 15 12 13 14 15 12 13 14 15 12 13 105 105 
105 105 105 105 105 105 105 105 105 105 105 105 105 105 105 105 16 17 18 19 105 105 105 105 105 105 106 106 105 105 105 105 
105 105 105 105 105 105 105 105 20 21 22 23 20 155 156 23 4 5 6 7 20 155 156 23 20 21 22 23 20 21 105 105 
105 105 105 105 105 105 105 105 8 9 10 11 8 157 158 11 8 9 10 11 8 157 158 11 8 9 10 11 8 9 105 105 
105 105 105 105 105 105 105 105 12 13 14 15 12 159 160 15 12 13 14 15 12 159 160 15 12 13 14 15 12 13 105 105 
105 105 105 105 105 105 105 105 105 105 105 105 105 105 105 105 106 106 105 105 105 105 105 105 105 105 105 105 105 105 105 105 
105 105 22 23 20 155 156 23 20 21 22 23 20 21 22 23 20 21 22 23 20 21 22 23 20 21 22 23 20 21 105 105 
105 105 10 11 8 157 158 11 8 9 10 11 8 9 10 11 8 9 10 11 8 9 10 11 8 9 10 11 8 9 105 105 
105 105 14 15 12 159 160 15 12 13 14 15 12 13 14 15 12 13 14 15 12 13 14 15 12 13 14 15 12 13 105 105 
105 105 105 105 105 105 106 106 16 17 18 19 105 105 105 105 105 105 18 19 105 105 106 106 105 105 105 105 105 105 105 105 
105 105 22 23 20 21 22 23 4 5 6 7 20 21 22 23 20 21 6 7 20 21 22 23 20 21 22 23 20 21 105 105 
105 105 10 11 8 9 10 11 8 9 10 11 8 9 10 11 8 9 10 11 8 9 10 11 8 9 10 11 8 9 105 105 
105 105 14 15 12 13 14 15 12 13 14 15 12 13 14 15 12 13 14 15 12 13 14 15 12 13 14 15 12 13 105 105 
105 105 105 105 105 105 105 105 105 105 105 105 16 17 18 19 105 105 105 105 105 105 105 105 16 17 18 19 16 17 105 105 
20 155 156 23 20 21 22 23 20 21 22 23 4 5 6 7 20 155 156 23 20 21 22 23 4 5 6 7 4 5 105 105 
8 157 158 11 8 9 10 11 8 9 10 11 8 9 10 11 8 157 158 11 8 9 10 11 8 9 10 11 8 9 105 105 
12 159 160 15 12 13 14 15 12 13 14 15 12 13 14 15 12 159 160 15 12 13 14 15 12 13 14 15 12 13 105 105 
105 105 105 105 16 17 18 19 16 17 18 19 16 17 18 19 105 105 105 105 105 105 105 105 105 105 18 19 16 17 105 105 

13 
LADDER 128 0 3 0
LADDER 320 0 3 0
LADDER 416 64 3 0
LADDER 256 128 3 1
LADDER 96 192 3 0
LADDER 352 192 3 0
STONE 304 80 0
ENEMY SKELETON 160 80
ENEMY SKELETON 224 144
ENEMY BAMBU 160 208
ENEMY BAMBU 64 16
ENEMY BAMBU 384 80
ENEMY BAMBU 352 144
