32 20
105 105 105 105 0 1 0 1 0 1 0 1 0 1 0 1 0 1 0 1 0 1 0 1 0 1 0 1 0 1 0 1 
105 105 105 105 1 0 1 0 1 0 1 0 1 0 1 0 1 0 1 0 1 0 1 0 1 0 1 0 1 0 1 0 
105 105 105 105 0 1 0 1 0 1 0 1 0 1 0 1 0 1 0 1 0 1 0 1 0 1 0 1 0 1 0 1 
105 105 105 105 1 0 1 0 1 0 1 0 1 0 1 0 1 0 106 106 105 105 105 105 1 0 1 0 1 0 1 0 
105 105 105 105 0 1 0 1 0 1 0 1 0 1 0 1 0 1 2 3 2 3 2 3 0 1 0 1 0 1 0 1 
105 105 105 105 1 0 1 0 1 0 1 0 1 0 1 0 1 0 1 0 1 0 1 0 1 0 1 0 1 0 1 0 
105 105 105 105 0 1 0 1 0 1 0 1 0 1 0 1 0 1 0 1 0 1 0 1 0 1 0 1 0 1 0 1 
105 105 105 105 1 0 1 0 105 105 1 0 105 105 105 105 105 105 105 105 1 0 1 0 1 0 1 0 105 105 105 105 
105 105 105 105 0 1 0 1 2 3 0 1 2 3 2 3 2 3 2 3 0 1 0 1 0 1 0 1 2 3 2 3 
105 105 105 105 1 0 1 0 1 0 1 0 1 0 1 0 1 0 1 0 1 0 1 0 1 0 1 0 1 0 1 0 
105 105 105 105 0 1 0 1 0 1 0 1 0 1 0 1 0 1 0 1 0 1 0 1 0 1 0 1 0 1 0 1 
105 105 105 105 1 0 1 0 1 0 1 0 1 0 1 0 1 0 1 0 1 0 1 0 105 105 105 105 1 0 1 0 
105 105 105 105 142 142 142 142 142 142 142 142 142 142 142 142 142 142 142 142 142 142 142 142 142 142 142 142 142 142 142 142 
105 105 105 105 141 141 141 141 141 141 141 141 141 141 141 141 141 141 141 141 141 141 141 141 141 141 141 141 141 141 141 141 
105 105 105 105 141 141 141 141 141 141 141 141 141 141 141 141 141 141 141 141 141 141 141 141 141 141 141 141 141 141 141 141 
105 105 105 105 141 141 141 141 141 141 141 141 141 141 141 141 141 141 141 141 105 105 105 105 141 141 141 141 141 141 141 141 
105 105 105 105 141 141 141 141 141 141 141 141 141 141 141 141 141 141 141 141 141 141 141 141 141 141 141 141 141 141 141 141 
105 105 105 105 141 141 141 141 141 141 141 141 141 141 141 141 141 141 141 141 141 141 141 141 141 141 141 141 141 141 141 141 
105 105 105 105 141 141 141 141 141 141 141 141 141 141 141 141 141 141 141 141 141 141 141 141 141 141 141 141 141 141 141 141 
105 105 105 105 105 105 105 105 105 105 105 105 105 105 105 105 105 105 105 105 105 105 105 105 105 105 105 105 105 105 105 105 

5
LADDER 288 64 3 0
STONE 224 80 0
ITEM 64 0 15
ENEMY WHITESTAR 320 16
ENEMY WHITESTAR 320 208

PIRANHAS