32 20
105 105 50 51 48 49 50 51 48 49 50 51 48 49 50 51 48 49 50 51 48 49 50 51 48 49 50 51 48 49 105 105 
105 105 54 55 52 53 54 55 52 53 54 55 52 53 54 55 52 53 54 55 52 53 54 55 52 53 54 55 52 53 105 105 
105 105 58 59 56 57 58 59 56 57 58 59 56 57 58 59 56 57 58 59 56 57 58 59 56 57 58 59 56 57 105 105 
105 105 46 47 44 45 46 47 44 45 46 47 105 105 105 105 105 105 105 105 44 45 46 47 105 105 105 105 105 105 105 105 
105 105 50 51 48 49 50 51 48 49 50 51 60 70 71 63 60 61 62 63 48 49 50 51 60 70 71 63 60 61 105 105 
105 105 54 55 52 53 54 55 52 53 54 55 52 72 73 55 52 53 54 55 52 53 54 55 52 72 73 55 52 53 105 105 
105 105 58 59 56 57 58 59 56 57 58 59 56 74 75 59 56 57 58 59 56 57 58 59 56 74 75 59 56 57 105 105 
105 105 46 47 105 105 106 106 105 105 105 105 105 105 105 105 44 45 46 47 105 105 106 106 105 105 105 105 105 105 105 105 
105 105 50 51 60 61 62 63 60 70 71 63 60 61 105 105 48 49 50 51 60 61 62 63 60 61 62 63 60 61 105 105 
105 105 54 55 52 53 54 55 52 72 73 55 52 53 105 105 52 53 54 55 52 53 54 55 52 53 54 55 52 53 105 105 
105 105 58 59 56 57 58 59 56 74 75 59 56 57 105 105 56 57 58 59 56 57 58 59 56 57 58 59 56 57 105 105 
105 105 105 105 105 105 105 105 105 105 106 106 105 105 105 105 105 105 105 105 44 45 46 47 44 45 46 47 105 105 105 105 
105 105 62 63 60 61 62 63 60 61 62 63 60 61 62 63 60 70 71 63 48 49 50 51 48 49 50 51 105 105 105 105 
105 105 54 55 52 53 54 55 52 53 54 55 52 53 54 55 52 72 73 55 52 53 54 55 52 53 54 55 105 105 105 105 
105 105 58 59 56 57 58 59 56 57 58 59 56 57 58 59 56 74 75 59 56 57 58 59 56 57 58 59 105 105 105 105 
105 105 46 47 44 45 105 105 105 105 105 105 105 105 105 105 106 106 105 105 105 105 105 105 105 105 105 105 105 105 105 105 
105 105 50 51 48 49 105 105 60 70 71 63 60 61 62 63 60 61 62 63 60 61 62 63 60 61 62 63 105 105 105 105 
105 105 54 55 52 53 105 105 52 72 73 55 52 53 54 55 52 53 54 55 52 53 54 55 52 53 54 55 105 105 105 105 
105 105 58 59 56 57 105 105 56 74 75 59 56 57 58 59 56 57 58 59 56 57 58 59 56 57 58 59 105 105 105 105 
105 105 105 105 105 105 105 105 105 105 105 105 105 105 105 105 105 105 105 105 105 105 105 105 105 105 105 105 105 105 105 105 

15 
LADDER 352 128 7 0
LADDER 384 0 3 0
LADDER 224 0 3 0
LADDER 96 0 7 0
LADDER 96 128 3 0
LADDER 160 192 3 0
LADDER 256 256 3 0
DOOR 416 272 1
STONE 416 272 0
STONE 160 80 0
STONE 288 16 0
ENEMY SKELETON 384 80
ENEMY SKELETON 96 144
ENEMY SKELETON 128 208
ENEMY SKELETON 384 208
