32 20
105 105 105 105 105 105 105 105 105 105 105 105 105 105 105 105 105 105 105 105 105 105 105 105 105 105 105 105 105 105 105 105 
105 105 105 105 105 105 105 105 105 105 105 105 105 105 105 105 105 105 105 105 105 105 105 105 105 105 105 105 105 105 105 105 
105 105 105 105 105 105 105 105 105 105 105 105 105 105 105 105 105 105 105 105 105 105 105 105 105 105 105 105 105 105 105 105 
105 105 105 105 105 105 105 105 105 105 105 105 105 105 105 105 105 105 105 105 105 105 105 105 105 105 105 105 105 105 105 105 
105 105 105 105 82 83 2 3 2 76 77 3 2 3 2 3 2 3 2 3 2 3 2 3 2 3 2 3 105 105 105 105 
105 105 105 105 84 85 1 0 1 78 79 0 1 0 1 0 1 0 1 0 1 0 1 0 1 0 1 0 105 105 105 105 
105 105 105 105 86 87 0 1 0 80 81 1 0 1 0 1 0 1 0 1 0 1 0 1 0 1 0 1 105 105 105 105 
105 105 105 105 105 105 105 105 105 105 106 106 105 105 105 105 1 0 1 0 105 105 106 106 105 105 105 105 105 105 105 105 
105 105 105 105 2 3 2 3 2 3 2 3 2 3 2 3 0 1 0 1 2 3 2 3 2 3 2 3 105 105 105 105 
105 105 105 105 1 0 1 0 1 0 1 0 1 0 1 0 1 0 1 0 1 0 1 0 1 0 1 0 105 105 105 105 
105 105 105 105 0 1 0 1 0 1 0 1 0 1 0 1 0 1 0 1 0 1 0 1 0 1 0 1 105 105 105 105 
105 105 105 105 1 0 1 0 105 105 105 105 105 105 106 106 105 105 105 105 105 105 105 105 105 105 105 105 105 105 105 105 
105 105 105 105 0 1 0 1 2 3 2 3 2 3 2 3 2 3 2 3 2 94 95 3 2 3 88 89 105 105 105 105 
105 105 105 105 1 0 1 0 1 0 1 0 1 0 1 0 1 0 1 0 1 96 97 0 1 0 90 91 105 105 105 105 
105 105 105 105 0 1 0 1 0 1 0 1 0 1 0 1 0 1 0 1 0 1 0 1 0 1 92 93 105 105 105 105 
105 105 105 105 1 0 1 0 1 0 1 0 105 105 105 105 105 105 105 105 105 105 105 105 105 105 105 105 105 105 105 105 
2 3 2 3 0 1 0 1 0 1 0 1 2 3 2 3 2 3 2 3 2 3 2 3 105 105 105 105 105 105 105 105 
1 0 1 0 1 0 1 0 1 0 1 0 1 0 1 0 1 0 1 0 1 0 1 0 105 105 105 105 105 105 105 105 
0 1 0 1 0 1 0 1 0 1 0 1 0 1 0 1 0 1 0 1 0 1 0 1 105 105 105 105 105 105 105 105 
105 105 105 105 105 105 105 105 105 105 105 105 105 105 1 0 1 0 1 0 1 0 1 0 105 105 105 105 105 105 105 105 

8
LADDER 160 128 3 0
LADDER 352 128 3 0
LADDER 224 192 3 0
DOOR 272 144 1
STONE 128 272 0
STONE 272 144 0
STONE 384 208 0
ENEMY KNIGHTHEAD 224 96
