32 20
105 105 105 105 105 105 50 51 48 49 50 51 48 49 50 51 48 49 50 51 48 49 50 51 48 49 50 51 48 49 105 105 
105 105 105 105 105 105 54 55 52 53 54 55 52 53 54 55 52 53 54 55 52 53 54 55 52 53 54 55 52 53 105 105 
105 105 105 105 105 105 58 59 56 57 58 59 56 57 58 59 56 57 58 59 56 57 58 59 56 57 58 59 56 57 105 105 
105 105 105 105 105 105 106 106 105 105 105 105 105 105 106 106 44 45 46 47 44 45 106 106 105 105 105 105 105 105 105 105 
105 105 62 63 60 61 62 63 60 70 71 63 60 61 62 63 48 49 50 51 48 49 62 63 105 105 105 105 105 105 105 105 
105 105 54 55 52 53 54 55 52 72 73 55 52 53 54 55 52 53 54 55 52 53 54 55 105 105 105 105 105 105 105 105 
105 105 58 59 56 57 58 59 56 74 75 59 56 57 58 59 56 57 58 59 56 57 58 59 105 105 105 105 105 105 105 105 
105 105 46 47 44 45 46 47 105 105 105 105 105 105 106 106 105 105 105 105 105 105 106 106 105 105 105 105 105 105 105 105 
105 105 50 51 48 49 50 51 105 105 105 105 105 105 62 63 60 70 71 63 60 61 62 63 60 61 62 63 60 61 105 105 
105 105 54 55 52 53 54 55 105 105 105 105 105 105 54 55 52 72 73 55 52 53 54 55 52 53 54 55 52 53 105 105 
105 105 58 59 56 57 58 59 105 105 105 105 105 105 58 59 56 74 75 59 56 57 58 59 56 57 58 59 56 57 105 105 
105 105 105 105 105 105 106 106 105 105 105 105 105 105 106 106 105 105 105 105 105 105 106 106 105 105 105 105 105 105 105 105 
105 105 105 105 105 105 62 63 60 61 62 63 60 61 62 63 105 105 105 105 105 105 62 63 105 105 105 105 105 105 105 105 
105 105 105 105 105 105 54 55 52 53 54 55 52 53 54 55 105 105 105 105 105 105 54 55 105 105 105 105 105 105 105 105 
105 105 105 105 105 105 58 59 56 57 58 59 56 57 58 59 105 105 105 105 105 105 58 59 105 105 105 105 105 105 105 105 
105 105 105 105 105 105 46 47 44 45 46 47 44 45 106 106 105 105 105 105 105 105 46 47 105 105 105 105 105 105 105 105 
105 105 105 105 105 105 50 51 48 49 50 51 48 49 62 63 60 70 71 63 60 61 50 51 60 70 71 63 60 61 62 63 
105 105 105 105 105 105 54 55 52 53 54 55 52 53 54 55 52 72 73 55 52 53 54 55 52 72 73 55 52 53 54 55 
105 105 105 105 105 105 58 59 56 57 58 59 56 57 58 59 56 74 75 59 56 57 58 59 56 74 75 59 56 57 58 59 
105 105 105 105 105 105 105 105 105 105 105 105 105 105 105 105 105 105 105 105 105 105 105 105 105 105 105 105 105 105 105 105 

18 
LADDER 96 0 3 0
LADDER 224 0 3 0
LADDER 352 0 3 0
LADDER 352 64 3 0
LADDER 224 64 3 0
LADDER 96 64 7 0
LADDER 224 128 3 0
LADDER 352 128 3 0
LADDER 352 192 7 0
LADDER 224 192 3 0
LADDER 224 256 3 0
LADDER 96 192 7 0
STONE 304 272 0
STONE 176 80 0
STONE 416 16 0
ENEMY KNIGHT 384 144
ENEMY KNIGHT 256 80
ENEMY KNIGHT 128 16
