32 20
105 105 105 105 105 105 105 105 105 105 105 105 4 5 6 7 4 5 6 7 4 5 6 7 4 5 6 7 4 5 6 7 
105 105 105 105 105 105 105 105 105 105 105 105 8 9 10 11 8 9 10 11 8 9 10 11 8 9 10 11 8 9 10 11 
105 105 105 105 105 105 105 105 105 105 105 105 12 13 14 15 12 13 14 15 12 13 14 15 12 13 14 15 12 13 14 15 
105 105 105 105 105 105 105 105 105 105 105 105 16 17 18 19 105 105 105 105 105 105 105 105 105 105 105 105 105 105 105 105 
105 105 22 23 20 155 156 23 20 21 22 23 4 5 6 7 105 105 105 105 20 21 22 23 20 21 22 23 20 21 105 105 
105 105 10 11 8 157 158 11 8 9 10 11 8 9 10 11 105 105 105 105 8 9 10 11 8 9 10 11 8 9 105 105 
105 105 14 15 12 159 160 15 12 13 14 15 12 13 14 15 105 105 105 105 12 13 14 15 12 13 14 15 12 13 105 105 
105 105 105 105 105 105 106 106 105 105 105 105 105 105 105 105 105 105 105 105 16 17 18 19 105 105 18 19 16 17 105 105 
105 105 22 23 20 21 22 23 20 21 22 23 105 105 105 105 20 21 22 23 4 5 6 7 105 105 6 7 4 5 22 23 
105 105 10 11 8 9 10 11 8 9 10 11 105 105 105 105 8 9 10 11 8 9 10 11 105 105 10 11 8 9 10 11 
105 105 14 15 12 13 14 15 12 13 14 15 105 105 105 105 12 13 14 15 12 13 14 15 105 105 14 15 12 13 14 15 
105 105 105 105 105 105 105 105 16 17 18 19 105 105 105 105 16 17 18 19 105 105 105 105 105 105 105 105 105 105 105 105 
105 105 22 23 20 21 22 23 4 5 6 7 105 105 105 105 4 5 6 7 20 21 22 23 20 21 22 23 20 21 105 105 
105 105 10 11 8 9 10 11 8 9 10 11 105 105 105 105 8 9 10 11 8 9 10 11 8 9 10 11 8 9 105 105 
105 105 14 15 12 13 14 15 12 13 14 15 105 105 105 105 12 13 14 15 12 13 14 15 12 13 14 15 12 13 105 105 
105 105 18 19 16 17 105 105 106 106 105 105 105 105 105 105 105 105 105 105 105 105 105 105 105 105 18 19 16 17 105 105 
105 105 6 7 4 5 22 23 20 21 22 23 105 105 105 105 20 21 22 23 20 155 156 23 20 21 6 7 4 5 22 23 
105 105 10 11 8 9 10 11 8 9 10 11 105 105 105 105 8 9 10 11 8 157 158 11 8 9 10 11 8 9 10 11 
105 105 14 15 12 13 14 15 12 13 14 15 105 105 105 105 12 13 14 15 12 159 160 15 12 13 14 15 12 13 14 15 
105 105 105 105 105 105 105 105 105 105 18 19 105 105 105 105 16 17 18 19 105 105 105 105 105 105 105 105 105 105 105 105 

14 
LADDER 128 256 3 0
LADDER 96 128 3 0
STONE 160 80 20
STONE 368 272 0
STONE 416 144 0
KEYDOOR 320 0 1
ENEMY PORCUPINE 224 80
ENEMY PORCUPINE 96 144
ENEMY PORCUPINE 96 272
ENEMY BAMBU 320 208
ENEMY BAMBU 384 16
ENEMY BAMBU 128 208
ENEMY BAMBU 416 272
ENEMY BAMBU 96 80
