32 20
48 49 50 51 48 49 50 51 48 49 50 51 48 49 50 51 48 49 50 51 48 49 50 51 48 49 50 51 48 49 50 51 
52 53 54 55 52 53 54 55 52 53 54 55 52 53 54 55 52 53 54 55 52 53 54 55 52 53 54 55 52 53 54 55 
56 57 58 59 56 57 58 59 56 57 58 59 56 57 58 59 56 57 58 59 56 57 58 59 56 57 58 59 56 57 58 59 
44 45 46 47 44 45 46 47 44 45 46 47 44 45 46 47 44 45 46 47 44 45 46 47 44 45 46 47 44 45 46 47 
48 49 50 51 48 49 50 51 48 49 50 51 48 49 50 51 48 49 50 51 48 49 50 51 48 49 50 51 48 49 50 51 
52 53 54 55 52 53 54 55 52 53 54 55 52 53 54 55 52 53 54 55 52 53 54 55 52 53 54 55 52 53 54 55 
56 57 58 59 56 57 58 59 56 57 58 59 56 57 58 59 56 57 58 59 56 57 58 59 56 57 58 59 56 57 58 59 
105 105 105 105 105 105 105 105 105 105 105 105 105 105 105 105 105 105 105 105 105 105 105 105 105 105 105 105 105 105 105 105 
105 105 105 105 105 105 105 105 105 105 105 105 105 105 105 105 105 105 105 105 105 105 105 105 105 105 105 105 105 105 105 105 
105 105 105 105 105 105 105 105 105 105 105 105 105 105 105 105 105 105 105 105 105 105 105 105 105 105 105 105 105 105 105 105 
105 105 105 105 105 105 105 105 105 105 105 105 105 105 105 105 105 105 105 105 105 105 105 105 105 105 105 105 105 105 105 105 
105 105 105 105 105 105 105 105 105 105 105 105 105 105 105 105 105 105 105 105 105 105 105 105 105 105 105 105 105 105 105 105 
105 105 105 105 105 105 105 105 105 105 105 105 105 105 105 105 105 105 105 105 105 105 105 105 105 105 105 105 105 105 105 105 
105 105 105 105 105 105 105 105 105 105 105 105 105 105 105 105 105 105 105 105 105 105 105 105 105 105 105 105 105 105 105 105 
105 105 105 105 105 105 105 105 105 105 105 105 105 105 105 105 105 105 105 105 105 105 105 105 105 105 105 105 105 105 105 105 
105 105 105 105 105 105 105 105 105 105 105 105 105 105 105 105 105 105 105 105 105 105 105 105 105 105 105 105 105 105 105 105 
105 105 105 105 60 70 71 63 60 61 62 63 60 70 71 63 60 61 62 63 60 61 62 63 60 70 71 63 60 61 62 63 
105 105 105 105 52 72 73 55 52 53 54 55 52 72 73 55 52 53 54 55 52 53 54 55 52 72 73 55 52 53 54 55 
105 105 105 105 56 74 75 59 56 57 58 59 56 74 75 59 56 57 58 59 56 57 58 59 56 74 75 59 56 57 58 59 
105 105 105 105 105 105 105 105 105 105 105 105 105 105 105 105 105 105 105 105 44 45 46 47 105 105 105 105 105 105 105 105 

7 
STONE 240 80 0
STONE 272 80 -1
STONE 304 80 0
ENEMY BAT 256 256
ENEMY BAT 128 256
ENEMY BAT 128 64
ENEMY BAT 384 64

ROLLINGSTONES
