32 20
0 1 0 1 0 1 0 1 105 105 0 1 0 1 0 1 0 1 0 1 0 1 0 1 0 1 0 1 105 105 105 105 
1 0 1 0 1 0 1 0 105 105 1 0 1 0 1 0 1 0 1 0 1 0 1 0 1 0 1 0 105 105 105 105 
0 1 0 1 0 1 0 1 105 105 0 1 0 1 0 1 0 1 0 1 0 1 0 1 0 1 0 1 105 105 105 105 
105 105 105 105 105 105 1 0 105 105 105 105 105 105 105 105 105 105 105 105 105 105 105 105 1 0 1 0 105 105 105 105 
2 3 2 3 105 105 0 1 2 76 77 3 2 94 95 3 2 3 2 3 2 76 77 3 0 1 0 1 105 105 105 105 
1 0 1 0 105 105 1 0 1 78 79 0 1 96 97 0 1 0 1 0 1 78 79 0 1 0 1 0 105 105 105 105 
0 1 0 1 105 105 0 1 0 80 81 1 0 1 0 1 0 1 0 1 0 80 81 1 0 1 0 1 105 105 105 105 
1 0 105 105 105 105 105 105 105 105 105 105 105 105 105 105 105 105 105 105 105 105 106 106 105 105 105 105 105 105 105 105 
0 1 2 3 2 3 2 3 2 3 2 3 105 105 105 105 2 3 2 3 2 3 2 3 2 3 2 3 2 3 2 3 
1 0 1 0 1 0 1 0 1 0 1 0 105 105 105 105 1 0 1 0 1 0 1 0 1 0 1 0 1 0 1 0 
0 1 0 1 0 1 0 1 0 1 0 1 105 105 105 105 0 1 0 1 0 1 0 1 0 1 0 1 0 1 0 1 
105 105 105 105 105 105 105 105 1 0 1 0 105 105 105 105 1 0 105 105 105 105 105 105 1 0 1 0 1 0 1 0 
2 3 2 3 2 3 105 105 0 1 0 1 105 105 105 105 0 1 2 3 2 3 2 3 0 1 0 1 0 1 0 1 
1 0 1 0 1 0 105 105 1 0 1 0 105 105 105 105 1 0 1 0 1 0 1 0 1 0 1 0 1 0 1 0 
0 1 0 1 0 1 105 105 0 1 0 1 105 105 105 105 0 1 0 1 0 1 0 1 0 1 0 1 0 1 0 1 
1 0 1 0 105 105 105 105 105 105 1 0 105 105 105 105 105 105 105 105 105 105 105 105 105 105 105 105 105 105 105 105 
0 1 0 1 2 3 2 3 2 3 0 1 105 105 105 105 82 83 2 3 2 94 95 3 2 3 2 3 2 3 88 89 
1 0 1 0 1 0 1 0 1 0 1 0 105 105 105 105 84 85 1 0 1 96 97 0 1 0 1 0 1 0 90 91 
0 1 0 1 0 1 0 1 0 1 0 1 105 105 105 105 86 87 0 1 0 1 0 1 0 1 0 1 0 1 92 93 
105 105 105 105 105 105 105 105 105 105 105 105 105 105 105 105 105 105 105 105 105 105 105 105 105 105 105 105 105 105 105 105 

5 
LADDER 352 128 3 0
LADDER 224 0 3 0
STONE 304 80 0
STONE 272 80 0
STONE 400 272 0

FAIRY 176 80