32 20
105 105 105 105 0 1 0 1 0 1 0 1 0 1 0 1 0 1 0 1 0 1 0 1 0 1 0 1 0 1 105 105 
105 105 105 105 1 0 1 0 1 0 1 0 1 0 1 0 1 0 1 0 1 0 1 0 1 0 1 0 1 0 105 105 
105 105 105 105 0 1 0 1 0 1 0 1 0 1 0 1 0 1 0 1 0 1 0 1 0 1 0 1 0 1 105 105 
105 105 105 105 1 0 1 0 105 105 105 105 105 105 105 105 105 105 105 105 105 105 105 105 105 105 105 105 105 105 105 105 
105 105 105 105 0 1 0 1 105 105 2 3 2 98 98 3 2 3 105 105 2 3 2 3 2 64 65 3 2 3 2 3 
105 105 105 105 1 0 1 0 105 105 1 0 1 100 99 0 1 0 105 105 1 0 1 0 1 66 67 0 1 101 102 0 
105 105 105 105 0 1 0 1 105 105 0 1 0 1 100 1 0 1 105 105 0 1 0 1 0 68 69 1 0 103 104 1 
105 105 105 105 1 0 105 105 105 105 105 105 106 106 105 105 105 105 105 105 106 106 105 105 105 105 105 105 105 105 105 105 
105 105 105 105 0 1 2 3 2 3 105 105 2 3 2 3 2 3 105 105 2 3 2 3 2 3 2 3 2 3 105 105 
105 105 105 105 1 0 1 0 1 0 105 105 1 0 1 0 1 0 105 105 1 0 1 0 1 0 1 0 1 0 105 105 
105 105 105 105 0 1 0 1 0 1 105 105 0 1 0 1 0 1 105 105 0 1 0 1 0 1 0 1 0 1 105 105 
105 105 105 105 105 105 105 105 1 0 105 105 105 105 105 105 106 106 105 105 1 0 1 0 105 105 105 105 105 105 105 105 
2 3 2 3 2 3 2 3 0 1 2 3 2 3 2 3 2 3 105 105 0 1 0 1 2 3 2 3 2 3 105 105 
1 0 1 0 1 101 102 0 1 0 1 0 1 0 1 0 1 0 105 105 1 0 1 0 1 0 1 0 1 0 105 105 
0 1 0 1 0 103 104 1 0 1 0 1 0 1 0 1 0 1 105 105 0 1 0 1 0 1 0 1 0 1 105 105 
105 105 105 105 105 105 105 105 105 105 105 105 105 105 105 105 105 105 105 105 105 105 105 105 1 0 1 0 1 0 105 105 
2 3 2 3 2 64 65 3 2 98 98 3 2 3 2 3 2 64 65 3 2 98 98 3 0 1 0 1 0 1 105 105 
1 101 102 0 1 66 67 0 1 100 99 0 1 0 1 0 1 66 67 0 1 100 99 0 1 0 1 0 1 0 105 105 
0 103 104 1 0 68 69 1 0 1 100 1 0 1 0 1 0 68 69 1 0 1 100 1 0 1 0 1 0 1 105 105 
105 105 105 105 105 105 105 105 105 105 105 105 105 105 105 105 105 105 105 105 105 105 105 105 105 105 105 105 105 105 105 105 

11 
LADDER 192 128 3 0
LADDER 256 192 3 0
LADDER 320 128 7 0
STONE 256 80 -1
STONE 192 208 0
STONE 416 144 0
KEYDOOR 384 64 1
ENEMY BAT 416 128
ENEMY BAT 192 192
ENEMY BAT 192 256
ENEMY BAT 320 64
