32 20
105 105 105 105 105 105 105 105 105 105 105 105 36 37 38 39 36 37 38 39 36 37 38 39 36 37 38 39 105 105 105 105 
105 105 105 105 105 105 105 105 105 105 105 105 24 25 26 27 24 25 26 27 24 25 26 27 24 25 26 27 105 105 105 105 
105 105 105 105 105 105 105 105 105 105 105 105 28 29 30 31 28 29 30 31 28 29 30 31 28 29 30 31 105 105 105 105 
105 105 105 105 105 105 105 105 105 105 105 105 32 33 34 35 32 33 34 35 105 105 105 105 105 105 34 35 105 105 105 105 
105 105 38 39 36 119 120 39 36 37 38 39 36 37 38 39 36 37 38 39 105 105 105 105 105 105 38 39 105 105 105 105 
105 105 26 27 24 121 122 27 24 25 26 27 24 25 26 27 24 25 26 27 105 105 105 105 105 105 26 27 105 105 105 105 
105 105 30 31 28 123 124 31 28 29 30 31 28 29 30 31 28 29 30 31 105 105 105 105 105 105 30 31 105 105 105 105 
105 105 105 105 105 105 105 105 32 33 34 35 105 105 105 105 32 33 34 35 105 105 105 105 105 105 34 35 105 105 105 105 
105 105 38 39 36 37 38 39 36 37 38 39 36 119 120 39 36 37 38 39 105 105 105 105 105 105 38 39 105 105 105 105 
105 105 26 27 24 25 26 27 24 25 26 27 24 121 122 27 24 25 26 27 105 105 105 105 105 105 26 27 105 105 105 105 
105 105 30 31 28 29 30 31 28 29 30 31 28 123 124 31 28 29 30 31 105 105 105 105 105 105 30 31 105 105 105 105 
105 105 34 35 32 33 106 106 105 105 105 105 105 105 105 105 32 33 34 35 105 105 105 105 105 105 34 35 105 105 105 105 
105 105 38 39 36 37 38 39 36 119 120 39 36 37 38 39 36 37 38 39 105 105 105 105 105 105 38 39 105 105 105 105 
105 105 26 27 24 25 26 27 24 121 122 27 24 25 26 27 24 25 26 27 105 105 105 105 105 105 26 27 105 105 105 105 
105 105 30 31 28 29 30 31 28 123 124 31 28 29 30 31 28 29 30 31 105 105 105 105 105 105 30 31 105 105 105 105 
105 105 34 35 32 33 105 105 105 105 106 106 105 105 105 105 32 33 34 35 105 105 105 105 105 105 34 35 105 105 105 105 
105 105 38 39 36 37 38 39 36 37 38 39 36 119 120 39 36 37 38 39 105 105 105 105 105 105 38 39 105 105 105 105 
105 105 26 27 24 25 26 27 24 25 26 27 24 121 122 27 24 25 26 27 105 105 105 105 105 105 26 27 105 105 105 105 
105 105 30 31 28 29 30 31 28 29 30 31 28 123 124 31 28 29 30 31 105 105 105 105 105 105 30 31 105 105 105 105 
105 105 34 35 32 33 105 105 105 105 105 105 105 105 105 105 32 33 34 35 105 105 105 105 105 105 34 35 105 105 105 105 

6 
STONE 352 16 -2
STONE 192 80 0
LADDER 96 192 3 0
LADDER 160 256 3 0
ENEMY KNIGHT 48 80
ENEMY KNIGHT 160 144
