32 20
105 105 50 51 48 49 50 51 48 49 50 51 48 49 50 51 48 49 50 51 48 49 50 51 48 49 50 51 48 49 105 105 
105 105 54 55 52 53 54 55 52 53 54 55 52 53 54 55 52 53 54 55 52 53 54 55 52 53 54 55 52 53 105 105 
105 105 58 59 56 57 58 59 56 57 58 59 56 57 58 59 56 57 58 59 56 57 58 59 56 57 58 59 56 57 105 105 
105 105 105 105 105 105 105 105 105 105 105 105 106 106 105 105 105 105 105 105 105 105 105 105 105 105 105 105 105 105 105 105 
105 105 62 63 60 70 71 63 60 61 62 63 60 61 62 63 60 70 71 63 60 61 62 63 60 70 71 63 60 61 62 63 
105 105 54 55 52 72 73 55 52 53 54 55 52 53 54 55 52 72 73 55 52 53 54 55 52 72 73 55 52 53 54 55 
105 105 58 59 56 74 75 59 56 57 58 59 56 57 58 59 56 74 75 59 56 57 58 59 56 74 75 59 56 57 58 59 
105 105 105 105 105 105 105 105 44 45 46 47 105 105 105 105 105 105 105 105 44 45 46 47 105 105 105 105 105 105 105 105 
105 105 105 105 105 105 105 105 48 49 50 51 105 105 105 105 105 105 105 105 48 49 50 51 105 105 105 105 105 105 105 105 
105 105 105 105 105 105 105 105 52 53 54 55 105 105 105 105 105 105 105 105 52 53 54 55 105 105 105 105 105 105 105 105 
105 105 105 105 105 105 105 105 56 57 58 59 105 105 105 105 105 105 105 105 56 57 58 59 105 105 105 105 105 105 105 105 
105 105 105 105 105 105 105 105 44 45 46 47 105 105 105 105 105 105 105 105 44 45 105 105 105 105 105 105 105 105 105 105 
105 105 62 63 60 70 71 63 48 49 50 51 60 70 71 63 60 61 62 63 48 49 62 63 60 61 62 63 60 70 71 63 
105 105 54 55 52 72 73 55 52 53 54 55 52 72 73 55 52 53 54 55 52 53 54 55 52 53 54 55 52 72 73 55 
105 105 58 59 56 74 75 59 56 57 58 59 56 74 75 59 56 57 58 59 56 57 58 59 56 57 58 59 56 74 75 59 
105 105 105 105 105 105 106 106 105 105 105 105 105 105 106 106 105 105 105 105 105 105 105 105 106 106 105 105 105 105 105 105 
105 105 62 63 60 61 62 63 60 61 62 63 60 61 62 63 60 61 62 63 60 61 62 63 60 61 62 63 60 61 105 105 
105 105 54 55 52 53 54 55 52 53 54 55 52 53 54 55 52 53 54 55 52 53 54 55 52 53 54 55 52 53 105 105 
105 105 58 59 56 57 58 59 56 57 58 59 56 57 58 59 56 57 58 59 56 57 58 59 56 57 58 59 56 57 105 105 
105 105 46 47 44 45 46 47 44 45 46 47 44 45 46 47 44 45 46 47 44 45 46 47 44 45 46 47 44 45 105 105 

10 
LADDER 192 64 3 0
LADDER 224 256 5 0
LADDER 96 256 5 0
LADDER 384 256 5 0
STONE 416 80 0
STONE 96 16 -1
ENEMY SKELETON 128 16
ENEMY SKELETON 256 80
ENEMY SKELETON 384 16
ENEMY SKELETON 256 208

APPEARWALL 13 12