32 20
4 5 6 7 4 5 6 7 4 5 6 7 4 5 6 7 4 5 6 7 105 105 105 105 105 105 105 105 105 105 105 105 
8 9 10 11 8 9 10 11 8 9 10 11 8 9 10 11 8 9 10 11 105 105 105 105 105 105 105 105 105 105 105 105 
12 13 14 15 12 13 14 15 12 13 14 15 12 13 14 15 12 13 14 15 105 105 105 105 105 105 105 105 105 105 105 105 
105 105 105 105 105 105 105 105 105 105 105 105 105 105 18 19 16 17 18 19 105 105 105 105 105 105 105 105 105 105 105 105 
20 21 22 23 105 105 22 23 20 21 22 23 20 21 6 7 4 5 6 7 20 21 22 23 20 155 156 23 105 105 105 105 
8 9 10 11 105 105 10 11 8 9 10 11 8 9 10 11 8 9 10 11 8 9 10 11 8 157 158 11 105 105 105 105 
12 13 14 15 105 105 14 15 12 13 14 15 12 13 14 15 12 13 14 15 12 13 14 15 12 159 160 15 105 105 105 105 
105 105 18 19 105 105 105 105 16 17 18 19 105 105 105 105 106 106 18 19 16 17 18 19 105 105 105 105 105 105 105 105 
20 21 6 7 105 105 22 23 4 5 6 7 20 21 22 23 20 21 6 7 4 5 6 7 105 105 105 105 105 105 105 105 
8 9 10 11 105 105 10 11 8 9 10 11 8 9 10 11 8 9 10 11 8 9 10 11 105 105 105 105 105 105 105 105 
12 13 14 15 105 105 14 15 12 13 14 15 12 13 14 15 12 13 14 15 12 13 14 15 105 105 105 105 105 105 105 105 
105 105 105 105 105 105 105 105 105 105 18 19 16 17 105 105 106 106 105 105 105 105 105 105 105 105 105 105 105 105 105 105 
20 21 22 23 105 105 105 105 105 105 6 7 4 5 22 23 20 21 22 23 20 155 156 23 105 105 105 105 105 105 105 105 
8 9 10 11 105 105 105 105 105 105 10 11 8 9 10 11 8 9 10 11 8 157 158 11 105 105 105 105 105 105 105 105 
12 13 14 15 105 105 105 105 105 105 14 15 12 13 14 15 12 13 14 15 12 159 160 15 105 105 105 105 105 105 105 105 
105 105 18 19 105 105 105 105 105 105 18 19 16 17 18 19 105 105 105 105 105 105 105 105 105 105 105 105 105 105 105 105 
20 21 6 7 105 105 105 105 105 105 6 7 4 5 6 7 20 155 156 23 20 21 22 23 105 105 105 105 105 105 105 105 
8 9 10 11 105 105 105 105 105 105 10 11 8 9 10 11 8 157 158 11 8 9 10 11 105 105 105 105 105 105 105 105 
12 13 14 15 105 105 105 105 105 105 14 15 12 13 14 15 12 159 160 15 12 13 14 15 105 105 105 105 105 105 105 105 
105 105 105 105 105 105 105 105 105 105 105 105 105 105 105 105 105 105 105 105 16 17 18 19 105 105 105 105 105 105 105 105 

9 
LADDER 256 128 3 0
LADDER 256 192 3 0
DOOR 224 80 1
STONE 160 272 0
STONE 192 272 0
STONE 224 80 0
ENEMY SKELETON 160 16
ENEMY SKELETON 256 144
ENEMY SKELETON 320 208

APPEARWALL 8 0
