32 20
0 1 0 1 0 1 0 1 0 1 0 1 0 1 0 1 0 1 0 1 0 1 0 1 0 1 0 1 0 1 105 105 
1 0 1 0 1 0 1 0 1 0 1 0 1 0 1 0 1 0 1 0 1 0 1 0 1 0 1 0 1 0 105 105 
0 1 0 1 0 1 0 1 0 1 0 1 0 1 0 1 0 1 0 1 0 1 0 1 0 1 0 1 0 1 105 105 
105 105 105 105 105 105 105 105 1 0 1 0 106 106 105 105 105 105 105 105 105 105 105 105 105 105 105 105 105 105 105 105 
105 105 2 3 2 3 2 3 0 1 0 1 2 3 2 3 2 3 2 3 2 3 2 3 2 3 2 3 2 3 105 105 
105 105 1 0 1 0 1 0 1 0 1 0 1 0 1 0 1 0 1 0 1 0 1 0 1 0 1 0 1 0 105 105 
105 105 0 1 0 1 0 1 0 1 0 1 0 1 0 1 0 1 0 1 0 1 0 1 0 1 0 1 0 1 105 105 
105 105 105 105 105 105 105 105 105 105 105 105 105 105 105 105 105 0 1 0 1 105 105 105 105 105 106 106 105 105 105 105 
105 105 2 3 2 3 2 3 105 105 105 105 2 3 2 3 2 1 0 1 0 3 2 3 2 3 2 3 2 3 105 105 
105 105 1 0 1 0 1 0 105 105 105 105 1 0 1 0 1 0 1 0 1 0 1 0 1 0 1 0 1 0 105 105 
105 105 0 1 0 1 0 1 105 105 105 105 0 1 0 1 0 1 0 1 0 1 0 1 0 1 0 1 0 1 105 105 
105 105 105 105 1 0 1 0 105 105 105 105 105 105 105 105 105 105 105 105 105 105 105 105 1 0 1 0 1 0 105 105 
105 105 2 3 0 1 0 1 2 3 2 3 2 3 2 3 2 3 2 3 2 3 2 3 0 1 0 1 0 1 105 105 
105 105 1 0 1 0 1 0 1 0 1 0 1 0 1 0 1 0 1 0 1 0 1 0 1 0 1 0 1 0 105 105 
105 105 0 1 0 1 0 1 0 1 0 1 0 1 0 1 0 1 0 1 0 1 0 1 0 1 0 1 0 1 105 105 
105 105 105 105 105 105 105 105 105 105 105 105 1 0 1 0 105 105 105 105 105 105 105 105 105 105 105 105 105 105 105 105 
82 83 2 3 2 94 95 3 2 3 2 3 0 1 0 1 2 3 2 3 2 3 2 3 2 3 2 3 2 3 105 105 
84 85 1 0 1 96 97 0 1 0 1 0 1 0 1 0 1 0 1 0 1 0 1 0 1 0 1 0 1 0 105 105 
86 87 0 1 0 1 0 1 0 1 0 1 0 1 0 1 0 1 0 1 0 1 0 1 0 1 0 1 0 1 105 105 
105 105 105 105 105 105 105 105 105 105 105 105 1 0 105 105 105 105 105 105 105 105 105 105 105 105 105 105 105 105 105 105 

12
ARMOUR 32 64 1
ARMOUR 32 192 1
ARMOUR 448 256 0
LADDER 416 128 7 0
LADDER 384 0 3 0
LADDER 192 64 3 0
STONE 128 208 0
STONE 240 144 0
STONE 384 80 33
KEYDOOR 304 192 1
ENEMY WORM 352 272 0
ENEMY WORM 272 144 0
