32 20
105 105 50 51 48 49 50 51 48 49 50 51 48 49 50 51 48 49 50 51 48 49 50 51 48 49 50 51 48 49 105 105 
105 105 54 55 52 53 54 55 52 53 54 55 52 53 54 55 52 53 54 55 52 53 54 55 52 53 54 55 52 53 105 105 
105 105 58 59 56 57 58 59 56 57 58 59 56 57 58 59 56 57 58 59 56 57 58 59 56 57 58 59 56 57 105 105 
105 105 105 105 106 106 105 105 44 45 46 47 105 105 105 105 105 105 105 105 105 105 105 105 105 105 46 47 44 45 105 105 
105 105 62 63 60 61 62 63 48 49 50 51 60 70 71 63 60 61 62 63 60 70 71 63 60 61 50 51 48 49 105 105 
105 105 54 55 52 53 54 55 52 53 54 55 52 72 73 55 52 53 54 55 52 72 73 55 52 53 54 55 52 53 105 105 
105 105 58 59 56 57 58 59 56 57 58 59 56 74 75 59 56 57 58 59 56 74 75 59 56 57 58 59 56 57 105 105 
105 105 46 47 44 45 46 47 105 105 105 105 105 105 105 105 44 45 46 47 105 105 105 105 105 105 105 105 105 105 105 105 
105 105 50 51 48 49 50 51 60 61 62 63 60 61 62 63 48 49 50 51 60 61 62 63 60 61 62 63 60 61 62 63 
105 105 54 55 52 53 54 55 52 53 54 55 52 53 54 55 52 53 54 55 52 53 54 55 52 53 54 55 52 53 54 55 
105 105 58 59 56 57 58 59 56 57 58 59 56 57 58 59 56 57 58 59 56 57 58 59 56 57 58 59 56 57 58 59 
105 105 46 47 44 45 46 47 44 45 46 47 106 106 105 105 105 105 106 106 44 45 46 47 44 45 46 47 44 45 46 47 
105 105 50 51 48 49 50 51 48 49 50 51 60 61 62 63 60 61 62 63 48 49 50 51 48 49 50 51 48 49 50 51 
105 105 54 55 52 53 54 55 52 53 54 55 52 53 54 55 52 53 54 55 52 53 54 55 52 53 54 55 52 53 54 55 
105 105 58 59 56 57 58 59 56 57 58 59 56 57 58 59 56 57 58 59 56 57 58 59 56 57 58 59 56 57 58 59 
105 105 105 105 106 106 105 105 44 45 46 47 44 45 46 47 105 105 106 106 105 105 105 105 105 105 105 105 105 105 105 105 
105 105 62 63 60 61 62 63 48 49 50 51 48 49 50 51 60 61 62 63 60 61 62 63 60 70 71 63 60 61 62 63 
105 105 54 55 52 53 54 55 52 53 54 55 52 53 54 55 52 53 54 55 52 53 54 55 52 72 73 55 52 53 54 55 
105 105 58 59 56 57 58 59 56 57 58 59 56 57 58 59 56 57 58 59 56 57 58 59 56 74 75 59 56 57 58 59 
105 105 105 105 105 105 105 105 44 45 46 47 105 105 105 105 105 105 105 105 44 45 46 47 105 105 105 105 105 105 105 105 

11 
LADDER 192 192 7 0
LADDER 288 192 3 0
LADDER 288 256 3 0
LADDER 64 64 11 0
LADDER 64 256 3 0
LADDER 448 0 7 0
KEYDOOR 256 0 1
STONE 160 80 0
STONE 416 208 0
ENEMY BAT 256 192
ENEMY BAT 256 64

ROLLINGSTONES
