32 20
105 105 105 105 48 49 50 51 48 49 105 105 48 49 50 51 48 49 50 51 105 105 50 51 48 49 50 51 105 105 105 105 
105 105 105 105 52 53 54 55 52 53 105 105 52 53 54 55 52 53 54 55 105 105 54 55 52 53 54 55 105 105 105 105 
105 105 105 105 56 57 58 59 56 57 105 105 56 57 58 59 56 57 58 59 105 105 58 59 56 57 58 59 105 105 105 105 
105 105 105 105 44 45 46 47 44 45 105 105 44 45 46 47 44 45 46 47 105 105 46 47 44 45 46 47 105 105 105 105 
105 105 105 105 48 49 50 51 48 49 105 105 48 49 50 51 48 49 50 51 105 105 50 51 48 49 50 51 105 105 105 105 
105 105 105 105 52 53 54 55 52 53 105 105 52 53 54 55 52 53 54 55 105 105 54 55 52 53 54 55 105 105 105 105 
105 105 105 105 56 57 58 59 56 57 105 105 56 57 58 59 56 57 58 59 105 105 58 59 56 57 58 59 105 105 105 105 
105 105 105 105 106 106 105 105 105 105 105 105 44 45 46 47 44 45 46 47 105 105 46 47 44 45 46 47 105 105 105 105 
60 61 62 63 60 61 62 63 60 61 105 105 48 49 50 51 48 49 50 51 105 105 50 51 48 49 50 51 105 105 105 105 
52 53 54 55 52 53 54 55 52 53 105 105 52 53 54 55 52 53 54 55 105 105 54 55 52 53 54 55 105 105 105 105 
56 57 58 59 56 57 58 59 56 57 105 105 56 57 58 59 56 57 58 59 105 105 58 59 56 57 58 59 105 105 105 105 
105 105 105 105 105 105 105 105 105 105 105 105 44 45 46 47 105 105 105 105 105 105 46 47 106 106 105 105 105 105 105 105 
105 105 105 105 60 61 62 63 60 70 71 63 48 49 50 51 60 61 62 63 105 105 50 51 60 61 62 63 105 105 105 105 
105 105 105 105 52 53 54 55 52 72 73 55 52 53 54 55 52 53 54 55 105 105 54 55 52 53 54 55 105 105 105 105 
105 105 105 105 56 57 58 59 56 74 75 59 56 57 58 59 56 57 58 59 105 105 58 59 56 57 58 59 105 105 105 105 
105 105 105 105 44 45 105 105 105 105 105 105 105 105 105 105 44 45 46 47 105 105 46 47 44 45 46 47 105 105 105 105 
105 105 105 105 48 49 62 63 60 61 62 63 105 105 105 105 48 49 50 51 105 105 50 51 48 49 50 51 105 105 105 105 
105 105 105 105 52 53 54 55 52 53 54 55 105 105 105 105 52 53 54 55 105 105 54 55 52 53 54 55 105 105 105 105 
105 105 105 105 56 57 58 59 56 57 58 59 105 105 105 105 56 57 58 59 105 105 58 59 56 57 58 59 105 105 105 105 
105 105 105 105 105 105 105 105 105 105 105 105 105 105 105 105 105 105 46 47 105 105 46 47 105 105 105 105 105 105 105 105 

10 
LADDER 64 128 3 0
LADDER 96 0 7 0
LADDER 256 0 11 0
LADDER 384 0 11 0
LADDER 384 192 7 0
STONE 128 80 0
STONE 128 208 0
STONE 416 144 -1
ENEMY KNIGHT 160 208
ENEMY KNIGHT 128 272
