32 20
105 105 38 39 36 37 38 39 36 37 38 39 36 37 38 39 36 37 38 39 36 37 38 39 36 37 38 39 36 37 38 39 
105 105 26 27 24 25 26 27 24 25 26 27 24 25 26 27 24 25 26 27 24 25 26 27 24 25 26 27 24 25 26 27 
105 105 30 31 28 29 30 31 28 29 30 31 28 29 30 31 28 29 30 31 28 29 30 31 28 29 30 31 28 29 30 31 
105 105 105 105 106 106 105 105 32 33 34 35 32 33 34 35 32 33 34 35 105 105 105 105 105 105 105 105 105 105 105 105 
105 105 42 43 40 41 42 43 36 37 38 39 36 37 38 39 36 37 38 39 105 105 105 105 40 119 120 43 40 41 42 43 
105 105 26 27 24 25 26 27 24 25 26 27 24 25 26 27 24 25 26 27 105 105 105 105 24 121 122 27 24 25 26 27 
105 105 30 31 28 29 30 31 28 29 30 31 28 29 30 31 28 29 30 31 105 105 105 105 28 123 124 31 28 29 30 31 
105 105 34 35 32 33 34 35 105 105 105 105 32 33 34 35 105 105 105 105 105 105 105 105 105 105 106 106 32 33 34 35 
105 105 38 39 36 37 38 39 105 105 105 105 36 37 38 39 105 105 105 105 105 105 105 105 40 41 42 43 36 37 38 39 
105 105 26 27 24 25 26 27 105 105 105 105 24 25 26 27 105 105 105 105 105 105 105 105 24 25 26 27 24 25 26 27 
105 105 30 31 28 29 30 31 105 105 105 105 28 29 30 31 105 105 105 105 105 105 105 105 28 29 30 31 28 29 30 31 
105 105 34 35 32 33 34 35 105 105 105 105 105 105 105 105 105 105 105 105 105 105 105 105 32 33 34 35 32 33 34 35 
105 105 38 39 36 37 38 39 40 119 120 43 40 41 105 105 105 105 42 43 40 119 120 43 36 37 38 39 36 37 38 39 
105 105 26 27 24 25 26 27 24 121 122 27 24 25 105 105 105 105 26 27 24 121 122 27 24 25 26 27 24 25 26 27 
105 105 30 31 28 29 30 31 28 123 124 31 28 29 105 105 105 105 30 31 28 123 124 31 28 29 30 31 28 29 30 31 
105 105 34 35 32 33 34 35 105 105 105 105 105 105 105 105 105 105 105 105 105 105 105 105 32 33 34 35 32 33 34 35 
105 105 38 39 36 37 38 39 40 41 42 43 40 119 120 43 40 119 120 43 40 41 42 43 36 37 38 39 36 37 38 39 
105 105 26 27 24 25 26 27 24 25 26 27 24 121 122 27 24 121 122 27 24 25 26 27 24 25 26 27 24 25 26 27 
105 105 30 31 28 29 30 31 28 29 30 31 28 123 124 31 28 123 124 31 28 29 30 31 28 29 30 31 28 29 30 31 
105 105 105 105 105 105 105 105 105 105 105 105 105 105 105 105 105 105 105 105 105 105 105 105 105 105 105 105 105 105 105 105 

5 
LADDER 416 128 11 0
LADDER 64 64 15 0
STONE 176 272 -1
STONE 240 272 0
STONE 304 272 0

BUTTERFLY