32 20
105 105 6 7 4 5 6 7 4 5 6 7 4 5 6 7 4 5 6 7 4 5 6 7 4 5 6 7 4 5 6 7 
105 105 10 11 8 9 10 11 8 9 10 11 8 9 10 11 8 9 10 11 8 9 10 11 8 9 10 11 8 9 10 11 
105 105 14 15 12 13 14 15 12 13 14 15 12 13 14 15 12 13 14 15 12 13 14 15 12 13 14 15 12 13 14 15 
105 105 105 105 105 105 105 105 106 106 105 105 105 105 105 105 105 105 105 105 105 105 105 105 105 105 105 105 105 105 105 105 
20 155 156 21 20 21 20 21 20 21 20 21 20 21 20 21 20 21 20 21 20 155 156 21 20 21 20 21 20 21 20 21 
8 157 158 11 8 9 10 11 8 9 10 11 8 9 10 11 8 9 10 11 8 157 158 11 8 9 10 11 8 9 10 11 
12 159 160 15 12 13 14 15 12 13 14 15 12 13 14 15 12 13 14 15 12 159 160 15 12 13 14 15 12 13 14 15 
105 105 105 105 105 105 105 105 105 105 105 105 105 105 105 105 106 106 105 105 105 105 105 105 16 17 18 19 105 105 105 105 
20 21 20 21 20 21 20 21 20 21 20 21 20 21 20 21 20 21 20 21 20 21 20 21 4 5 6 7 105 105 105 105 
8 9 10 11 8 9 10 11 8 9 10 11 8 9 10 11 8 9 10 11 8 9 10 11 8 9 10 11 105 105 105 105 
12 13 14 15 12 13 14 15 12 13 14 15 12 13 14 15 12 13 14 15 12 13 14 15 12 13 14 15 105 105 105 105 
105 105 105 105 105 105 105 105 105 105 105 105 105 105 105 105 105 105 105 105 105 105 105 105 105 105 105 105 105 105 105 105 
20 155 156 21 20 21 20 21 20 21 20 21 20 155 156 21 20 21 20 21 20 21 20 21 20 21 20 21 105 105 105 105 
8 157 158 11 8 9 10 11 8 9 10 11 8 157 158 11 8 9 10 11 8 9 10 11 8 9 10 11 105 105 105 105 
12 159 160 15 12 13 14 15 12 13 14 15 12 159 160 15 12 13 14 15 12 13 14 15 12 13 14 15 105 105 105 105 
105 105 105 105 105 105 105 105 106 106 105 105 105 105 105 105 105 105 105 105 105 105 105 105 105 105 105 105 105 105 105 105 
20 21 20 21 20 21 20 21 20 21 20 21 20 21 20 21 20 21 20 21 20 21 20 21 20 155 156 21 20 21 20 21 
8 9 10 11 8 9 10 11 8 9 10 11 8 9 10 11 8 9 10 11 8 9 10 11 8 157 158 11 8 9 10 11 
12 13 14 15 12 13 14 15 12 13 14 15 12 13 14 15 12 13 14 15 12 13 14 15 12 159 160 15 12 13 14 15 
105 105 105 105 105 105 105 105 105 105 105 105 105 105 105 105 105 105 105 105 105 105 105 105 105 105 105 105 105 105 105 105 

10 
LADDER 128 64 3 0
LADDER 128 256 3 0
LADDER 256 0 3 0
LADDER 256 128 3 0
ENEMY PORCUPINE 128 16
ENEMY PORCUPINE 256 80
ENEMY PORCUPINE 176 144
STONE 176 208 0
ENEMY PORCUPINE 384 208
ENEMY PORCUPINE 256 272
