32 20
105 105 105 105 105 105 105 105 105 105 105 105 105 105 38 39 36 37 105 105 105 105 105 105 105 105 105 105 105 105 105 105 
105 105 105 105 105 105 105 105 105 105 105 105 105 105 26 27 24 25 105 105 105 105 105 105 105 105 105 105 105 105 105 105 
105 105 105 105 105 105 105 105 105 105 105 105 105 105 30 31 28 29 105 105 105 105 105 105 105 105 105 105 105 105 105 105 
105 105 105 105 105 105 105 105 105 105 105 105 105 105 34 35 32 33 105 105 105 105 105 105 105 105 105 105 105 105 105 105 
105 105 105 105 105 105 105 105 105 105 105 105 105 105 38 39 36 37 38 39 36 119 120 39 36 37 38 39 36 119 120 39 
105 105 105 105 105 105 105 105 105 105 105 105 105 105 26 27 24 25 26 27 24 121 122 27 24 25 26 27 24 121 122 27 
105 105 105 105 105 105 105 105 105 105 105 105 105 105 30 31 28 29 30 31 28 123 124 31 28 29 30 31 28 123 124 31 
105 105 105 105 105 105 105 105 105 105 105 105 105 105 34 35 32 33 105 105 105 105 105 105 105 105 105 105 105 105 105 105 
105 105 105 105 105 105 105 105 105 105 105 105 105 105 38 39 36 37 105 105 105 105 105 105 105 105 105 105 105 105 105 105 
105 105 105 105 105 105 105 105 105 105 105 105 105 105 26 27 24 25 105 105 105 105 105 105 105 105 105 105 105 105 105 105 
105 105 105 105 105 105 105 105 105 105 105 105 105 105 30 31 28 29 105 105 105 105 105 105 105 105 105 105 105 105 105 105 
105 105 105 105 105 105 105 105 105 105 105 105 105 105 34 35 32 33 105 105 105 105 105 105 105 105 105 105 105 105 105 105 
105 105 38 39 36 119 120 39 36 37 38 39 36 37 38 39 36 37 105 105 105 105 105 105 105 105 105 105 105 105 105 105 
105 105 26 27 24 121 122 27 24 25 26 27 24 25 26 27 24 25 105 105 105 105 105 105 105 105 105 105 105 105 105 105 
105 105 30 31 28 123 124 31 28 29 30 31 28 29 30 31 28 29 105 105 105 105 105 105 105 105 105 105 105 105 105 105 
105 105 105 105 105 105 105 105 105 105 105 105 105 105 34 35 32 33 105 105 105 105 105 105 105 105 105 105 105 105 105 105 
105 105 105 105 105 105 105 105 105 105 105 105 105 105 38 39 36 37 105 105 105 105 105 105 105 105 105 105 105 105 105 105 
105 105 105 105 105 105 105 105 105 105 105 105 105 105 26 27 24 25 105 105 105 105 105 105 105 105 105 105 105 105 105 105 
105 105 105 105 105 105 105 105 105 105 105 105 105 105 30 31 28 29 105 105 105 105 105 105 105 105 105 105 105 105 105 105 
105 105 105 105 105 105 105 105 105 105 105 105 105 105 34 35 32 33 105 105 105 105 105 105 105 105 105 105 105 105 105 105 

4 
STONE 32 208 11
STONE 384 80 0
ENEMY BOUNCINGBALL 160 224 3
ENEMY BOUNCINGBALL 416 96 2

APPEARWALL 20 4