32 20
105 105 105 105 36 37 38 39 36 37 38 39 36 37 38 39 36 37 38 39 36 37 38 39 36 37 38 39 36 37 105 105 
105 105 105 105 24 25 26 27 24 25 26 27 24 25 26 27 24 25 26 27 24 25 26 27 24 25 26 27 24 25 105 105 
105 105 105 105 28 29 30 31 28 29 30 31 28 29 30 31 28 29 30 31 28 29 30 31 28 29 30 31 28 29 105 105 
105 105 105 105 32 33 34 35 105 105 105 105 105 105 105 105 105 105 105 105 106 106 105 105 105 105 105 105 105 105 105 105 
105 105 105 105 36 37 38 39 40 41 42 43 40 119 120 43 40 41 42 43 40 41 42 43 40 119 120 43 40 41 105 105 
105 105 105 105 24 25 26 27 24 25 26 27 24 121 122 27 24 25 26 27 24 25 26 27 24 121 122 27 24 25 105 105 
105 105 105 105 28 29 30 31 28 29 30 31 28 123 124 31 28 29 30 31 28 29 30 31 28 123 124 31 28 29 105 105 
105 105 105 105 105 105 105 105 105 105 105 105 105 105 105 105 106 106 105 105 105 105 105 105 105 105 105 105 105 105 105 105 
105 105 105 105 105 105 105 105 105 105 105 105 40 41 42 43 40 41 42 43 40 119 120 43 40 41 42 43 40 41 42 43 
105 105 105 105 105 105 105 105 105 105 105 105 24 25 26 27 24 25 26 27 24 121 122 27 24 25 26 27 24 25 26 27 
105 105 105 105 105 105 105 105 105 105 105 105 28 29 30 31 28 29 30 31 28 123 124 31 28 29 30 31 28 29 30 31 
105 105 105 105 105 105 105 105 105 105 105 105 105 105 105 105 105 105 105 105 105 105 106 106 105 105 105 105 105 105 105 105 
105 105 105 105 105 105 105 105 105 105 105 105 40 41 42 43 40 119 120 43 40 41 42 43 40 119 120 43 40 41 105 105 
105 105 105 105 105 105 105 105 105 105 105 105 24 25 26 27 24 121 122 27 24 25 26 27 24 121 122 27 24 25 105 105 
105 105 105 105 105 105 105 105 105 105 105 105 28 29 30 31 28 123 124 31 28 29 30 31 28 123 124 31 28 29 105 105 
105 105 105 105 105 105 105 105 105 105 105 105 105 105 105 105 106 106 105 105 105 105 105 105 105 105 105 105 105 105 105 105 
105 105 105 105 105 105 105 105 105 105 105 105 40 119 120 43 40 41 42 43 40 119 120 43 40 41 42 43 40 41 105 105 
105 105 105 105 105 105 105 105 105 105 105 105 24 121 122 27 24 25 26 27 24 121 122 27 24 25 26 27 24 25 105 105 
105 105 105 105 105 105 105 105 105 105 105 105 28 123 124 31 28 29 30 31 28 123 124 31 28 29 30 31 28 29 105 105 
105 105 105 105 105 105 105 105 105 105 105 105 105 105 105 105 105 105 105 105 105 105 105 105 105 105 34 35 32 33 105 105 

15 
LADDER 224 0 3 0
LADDER 320 64 3 0
LADDER 256 128 3 0
LADDER 256 256 3 0
LADDER 352 192 3 0
STONE 416 16 -2
STONE 192 80 0
STONE 384 272 0
ENEMY BAT 448 256
ENEMY BAT 192 128
ENEMY BAT 160 192
ENEMY BAT 96 192
ENEMY BAT 96 256
ENEMY BAT 32 64
ENEMY BAT 256 64
