32 20
36 37 38 39 36 37 105 105 105 105 105 105 36 37 38 39 36 37 38 39 36 37 105 105 105 105 105 105 105 105 105 105 
24 25 26 27 24 25 105 105 105 105 105 105 24 25 26 27 24 25 26 27 24 25 105 105 105 105 105 105 105 105 105 105 
28 29 30 31 28 29 105 105 105 105 105 105 28 29 30 31 28 29 30 31 28 29 105 105 105 105 105 105 105 105 105 105 
105 105 105 105 105 105 105 105 105 105 105 105 32 33 34 35 32 33 34 35 32 33 105 105 105 105 105 105 105 105 105 105 
105 105 105 105 105 105 105 105 105 105 42 43 36 37 38 39 36 37 38 39 36 37 42 43 105 105 105 105 105 105 105 105 
105 105 105 105 105 105 105 105 105 105 26 27 24 25 26 27 24 25 26 27 24 25 26 27 105 105 105 105 105 105 105 105 
105 105 105 105 105 105 105 105 105 105 30 31 28 29 30 31 28 29 30 31 28 29 30 31 105 105 105 105 105 105 105 105 
105 105 105 105 105 105 105 105 105 105 34 35 32 33 34 35 32 33 34 35 32 33 34 35 105 105 105 105 105 105 105 105 
105 105 105 105 105 105 105 105 40 41 38 39 36 37 38 39 36 37 38 39 36 37 38 39 40 41 105 105 105 105 105 105 
105 105 105 105 105 105 105 105 24 25 26 27 24 25 26 27 24 25 26 27 24 25 26 27 24 25 105 105 105 105 105 105 
105 105 105 105 105 105 105 105 28 29 30 31 28 29 30 31 28 29 30 31 28 29 30 31 28 29 105 105 105 105 105 105 
105 105 105 105 105 105 105 105 32 33 34 35 32 33 34 35 32 33 34 35 32 33 34 35 32 33 105 105 105 105 105 105 
105 105 105 105 105 105 42 43 36 37 38 39 36 37 38 39 36 37 38 39 36 37 38 39 36 37 42 43 105 105 105 105 
105 105 105 105 105 105 26 27 24 25 26 27 24 25 26 27 24 25 26 27 24 25 26 27 24 25 26 27 105 105 105 105 
105 105 105 105 105 105 30 31 28 29 30 31 28 29 30 31 28 29 30 31 28 29 30 31 28 29 30 31 105 105 105 105 
105 105 105 105 105 105 34 35 32 33 34 35 32 33 34 35 32 33 34 35 32 33 34 35 32 33 34 35 105 105 105 105 
40 41 42 43 40 41 38 39 36 37 38 39 36 37 38 39 36 37 38 39 36 37 38 39 36 37 38 39 40 41 105 105 
24 25 26 27 24 25 26 27 24 25 26 27 24 25 26 27 24 25 26 27 24 25 26 27 24 25 26 27 24 25 105 105 
28 29 30 31 28 29 30 31 28 29 30 31 28 29 30 31 28 29 30 31 28 29 30 31 28 29 30 31 28 29 105 105 
105 105 34 35 32 33 105 105 105 105 105 105 32 33 34 35 32 33 34 35 32 33 34 35 32 33 34 35 32 33 105 105 

8 
LADDER 64 0 3 0
ENEMY BAT 96 192
ENEMY BAT 128 128
ENEMY BAT 160 64
ENEMY BAT 352 64
ENEMY BAT 384 128
ENEMY BAT 416 192
STONE 96 272 -2
