32 20
4 5 6 7 4 5 6 7 4 5 6 7 4 5 6 7 4 5 6 7 4 5 6 7 105 105 105 105 105 105 105 105 
8 9 10 11 8 9 10 11 8 9 10 11 8 9 10 11 8 9 10 11 8 9 10 11 105 105 105 105 105 105 105 105 
12 13 14 15 12 13 14 15 12 13 14 15 12 13 14 15 12 13 14 15 12 13 14 15 105 105 105 105 105 105 105 105 
105 105 105 105 105 105 105 105 105 105 105 105 105 105 105 105 105 105 105 105 106 106 106 106 105 105 105 105 105 105 105 105 
105 105 105 105 105 105 105 105 105 105 105 105 105 105 105 105 105 105 105 105 20 21 20 21 105 105 105 105 105 105 105 105 
105 105 105 105 105 105 105 105 105 105 105 105 105 105 105 105 105 105 105 105 8 9 10 11 105 105 105 105 105 105 105 105 
105 105 105 105 105 105 105 105 105 105 105 105 105 105 105 105 105 105 105 105 12 13 14 15 105 105 105 105 105 105 105 105 
105 105 105 105 105 105 105 105 105 105 105 105 105 105 105 105 105 105 105 105 16 17 18 19 105 105 105 105 105 105 105 105 
105 105 105 105 105 105 105 105 105 105 105 105 105 105 105 105 105 105 105 105 4 5 6 7 105 105 105 105 105 105 105 105 
105 105 105 105 105 105 105 105 105 105 105 105 105 105 105 105 105 105 105 105 8 9 10 11 105 105 105 105 105 105 105 105 
105 105 105 105 105 105 105 105 105 105 105 105 105 105 105 105 105 105 105 105 12 13 14 15 105 105 105 105 105 105 105 105 
105 105 105 105 105 105 105 105 105 105 105 105 105 105 105 105 105 105 105 105 16 17 18 19 105 105 105 105 105 105 105 105 
20 21 20 21 20 155 156 21 20 21 20 21 20 155 156 21 20 21 20 21 4 5 6 7 105 105 105 105 105 105 105 105 
8 9 10 11 8 157 158 11 8 9 10 11 8 157 158 11 8 9 10 11 8 9 10 11 105 105 105 105 105 105 105 105 
12 13 14 15 12 159 160 15 12 13 14 15 12 159 160 15 12 13 14 15 12 13 14 15 105 105 105 105 105 105 105 105 
105 105 105 105 105 105 105 105 105 105 105 105 105 105 105 105 105 105 105 105 106 106 106 106 105 105 105 105 105 105 105 105 
20 155 156 21 20 21 20 21 20 21 20 21 20 21 20 21 20 155 156 21 20 21 20 21 105 105 105 105 105 105 105 105 
8 157 158 11 8 9 10 11 8 9 10 11 8 9 10 11 8 157 158 11 8 9 10 11 105 105 105 105 105 105 105 105 
12 159 160 15 12 13 14 15 12 13 14 15 12 13 14 15 12 159 160 15 12 13 14 15 105 105 105 105 105 105 105 105 
105 105 105 105 105 105 105 105 105 105 105 105 105 105 105 105 105 105 105 105 105 105 105 105 105 105 105 105 105 105 105 105 

8 
LADDER 320 256 3 0
LADDER 320 64 11 1
STONE 160 272 0
ENEMY BAMBU 96 208
ENEMY BAMBU 256 208
ENEMY BAMBU 224 272
ENEMY BAMBU 256 16
ENEMY BAMBU 96 16
