32 20
105 105 38 39 36 37 105 105 105 105 105 105 36 37 38 39 36 37 38 39 36 37 105 105 105 105 105 105 105 105 105 105 
105 105 26 27 24 25 105 105 105 105 105 105 24 25 26 27 24 25 26 27 24 25 105 105 105 105 105 105 105 105 105 105 
105 105 30 31 28 29 105 105 105 105 105 105 28 29 30 31 28 29 30 31 28 29 105 105 105 105 105 105 105 105 105 105 
105 105 34 35 105 105 105 105 105 105 105 105 32 33 34 35 32 33 34 35 32 33 105 105 105 105 105 105 105 105 105 105 
105 105 38 39 40 41 105 105 105 105 105 105 36 37 38 39 36 37 38 39 36 37 105 105 105 105 105 105 105 105 105 105 
105 105 26 27 24 25 105 105 105 105 105 105 24 25 26 27 24 25 26 27 24 25 105 105 105 105 105 105 105 105 105 105 
105 105 30 31 28 29 105 105 105 105 105 105 28 29 30 31 28 29 30 31 28 29 105 105 105 105 105 105 105 105 105 105 
105 105 34 35 105 105 105 105 105 105 105 105 32 33 34 35 32 33 34 35 32 33 105 105 105 105 105 105 105 105 105 105 
105 105 38 39 40 41 105 105 105 105 105 105 36 37 38 39 36 37 38 39 36 37 105 105 105 105 105 105 105 105 105 105 
105 105 26 27 24 25 105 105 105 105 105 105 24 25 26 27 24 25 26 27 24 25 105 105 105 105 105 105 105 105 105 105 
105 105 30 31 28 29 105 105 105 105 105 105 28 29 30 31 28 29 30 31 28 29 105 105 105 105 105 105 105 105 105 105 
105 105 34 35 105 105 105 105 105 105 105 105 32 33 34 35 32 33 34 35 32 33 105 105 105 105 105 105 105 105 105 105 
105 105 38 39 40 41 105 105 105 105 105 105 36 37 38 39 36 37 38 39 36 37 105 105 105 105 105 105 105 105 105 105 
105 105 26 27 24 25 105 105 105 105 105 105 24 25 26 27 24 25 26 27 24 25 105 105 105 105 105 105 105 105 105 105 
105 105 30 31 28 29 105 105 105 105 105 105 28 29 30 31 28 29 30 31 28 29 105 105 105 105 105 105 105 105 105 105 
105 105 34 35 105 105 105 105 105 105 105 105 32 33 34 35 32 33 34 35 32 33 105 105 105 105 105 105 105 105 105 105 
105 105 38 39 40 41 105 105 105 105 105 105 36 37 38 39 36 37 38 39 36 37 105 105 105 105 105 105 105 105 105 105 
105 105 26 27 24 25 105 105 105 105 105 105 24 25 26 27 24 25 26 27 24 25 105 105 105 105 105 105 105 105 105 105 
105 105 30 31 28 29 105 105 105 105 105 105 28 29 30 31 28 29 30 31 28 29 105 105 105 105 105 105 105 105 105 105 
105 105 34 35 105 105 105 105 105 105 105 105 32 33 34 35 32 33 34 35 32 33 105 105 105 105 105 105 105 105 105 105 

4 
LADDER 64 0 3 0
ENEMY BAT 128 64
ENEMY BAT 128 128
ENEMY BAT 128 256
