32 20
4 5 6 7 4 5 6 7 4 5 6 7 4 5 6 7 4 5 6 7 4 5 6 7 4 5 6 7 4 5 6 7 
8 9 10 11 8 9 10 11 8 9 10 11 8 9 10 11 8 9 10 11 8 9 10 11 8 9 10 11 8 9 10 11 
12 13 14 15 12 13 14 15 12 13 14 15 12 13 14 15 12 13 14 15 12 13 14 15 12 13 14 15 12 13 14 15 
105 105 105 105 105 105 105 105 105 105 105 105 105 105 105 105 105 105 105 105 105 105 105 105 105 105 105 105 105 105 105 105 
20 21 20 21 20 21 20 21 20 155 156 21 20 21 20 21 20 21 20 21 20 155 156 21 20 21 20 21 20 21 105 105 
8 9 10 11 8 9 10 11 8 157 158 11 8 9 10 11 8 9 10 11 8 157 158 11 8 9 10 11 8 9 105 105 
12 13 14 15 12 13 14 15 12 159 160 15 12 13 14 15 12 13 14 15 12 159 160 15 12 13 14 15 12 13 105 105 
105 105 105 105 105 105 105 105 105 105 105 105 105 105 105 105 105 105 105 105 105 105 105 105 105 105 105 105 105 105 105 105 
20 21 20 21 20 155 156 21 20 21 20 21 20 21 20 21 20 155 156 21 20 21 20 21 20 21 20 21 20 21 105 105 
8 9 10 11 8 157 158 11 8 9 10 11 8 9 10 11 8 157 158 11 8 9 10 11 8 9 10 11 8 9 105 105 
12 13 14 15 12 159 160 15 12 13 14 15 12 13 14 15 12 159 160 15 12 13 14 15 12 13 14 15 12 13 105 105 
105 105 105 105 105 105 105 105 105 105 105 105 105 105 105 105 105 105 105 105 105 105 105 105 16 17 18 19 16 17 105 105 
20 21 20 21 20 21 20 21 20 155 156 21 20 21 20 21 20 21 20 21 20 155 156 21 4 5 6 7 4 5 105 105 
8 9 10 11 8 9 10 11 8 157 158 11 8 9 10 11 8 9 10 11 8 157 158 11 8 9 10 11 8 9 105 105 
12 13 14 15 12 13 14 15 12 159 160 15 12 13 14 15 12 13 14 15 12 159 160 15 12 13 14 15 12 13 105 105 
105 105 105 105 105 105 105 105 105 105 105 105 105 105 105 105 105 105 105 105 105 105 105 105 105 105 105 105 105 105 105 105 
105 105 105 105 20 21 20 21 20 21 20 21 20 155 156 21 20 21 20 21 20 21 20 21 20 21 20 21 20 155 156 21 
105 105 105 105 8 9 10 11 8 9 10 11 8 157 158 11 8 9 10 11 8 9 10 11 8 9 10 11 8 157 158 11 
105 105 105 105 14 13 14 15 12 13 14 15 12 159 160 15 12 13 14 15 12 13 14 15 12 13 14 15 12 159 160 15 
105 105 105 105 18 17 18 19 105 105 105 105 105 105 105 105 105 105 105 105 105 105 105 105 105 105 105 105 105 105 105 105 

7 
LADDER 352 0 3 0
KEYDOOR 416 0 1
STONE 240 144 -2
ENEMY KNIGHT 272 144
ENEMY KNIGHT 352 208
ENEMY KNIGHT 384 80
ENEMY KNIGHT 192 16
