32 20
105 105 105 105 4 5 6 7 4 5 6 7 4 5 6 7 105 105 105 105 105 105 105 105 4 5 6 7 105 105 105 105 
105 105 105 105 8 9 10 11 8 9 10 11 8 9 10 11 105 105 105 105 105 105 105 105 8 9 10 11 105 105 105 105 
105 105 105 105 12 13 14 15 12 13 14 15 12 13 14 15 105 105 105 105 105 105 105 105 12 13 14 15 105 105 105 105 
105 105 105 105 16 17 18 19 105 105 105 105 105 105 105 105 105 105 105 105 105 105 105 105 16 17 18 19 105 105 105 105 
105 105 105 105 4 5 6 7 20 21 20 21 20 21 20 21 105 105 105 105 105 105 105 105 4 5 6 7 105 105 105 105 
105 105 105 105 8 9 10 11 8 9 10 11 8 9 10 11 105 105 105 105 105 105 105 105 8 9 10 11 105 105 105 105 
105 105 105 105 12 13 14 15 12 13 14 15 12 13 14 15 105 105 105 105 105 105 105 105 12 13 14 15 105 105 105 105 
105 105 105 105 105 105 105 105 106 106 18 19 16 17 18 19 105 105 105 105 105 105 105 105 105 105 106 106 105 105 105 105 
105 105 105 105 20 21 20 21 20 21 6 7 4 5 6 7 20 21 20 21 20 21 20 21 20 21 20 21 105 105 105 105 
105 105 105 105 8 9 10 11 8 9 10 11 8 9 10 11 8 9 10 11 8 9 10 11 8 9 10 11 105 105 105 105 
105 105 105 105 12 13 14 15 12 13 14 15 12 13 14 15 12 13 14 15 12 13 14 15 12 13 14 15 105 105 105 105 
105 105 105 105 16 17 18 19 16 17 18 19 16 17 18 19 16 17 105 105 105 105 18 19 16 17 18 19 105 105 105 105 
105 105 105 105 4 5 6 7 4 5 6 7 4 5 6 7 4 5 20 21 20 21 6 7 4 5 6 7 105 105 105 105 
105 105 105 105 8 9 10 11 8 9 10 11 8 9 10 11 8 9 10 11 8 9 10 11 8 9 10 11 105 105 105 105 
105 105 105 105 12 13 14 15 12 13 14 15 12 13 14 15 12 13 14 15 12 13 14 15 12 13 14 15 105 105 105 105 
105 105 105 105 105 105 105 105 105 105 105 105 105 105 105 105 16 17 18 19 16 17 18 19 105 105 105 105 105 105 105 105 
105 105 105 105 105 105 105 105 105 105 105 105 105 105 105 105 4 5 6 7 4 5 6 7 105 105 105 105 105 105 105 105 
105 105 105 105 105 105 105 105 105 105 105 105 105 105 105 105 8 9 10 11 8 9 10 11 105 105 105 105 105 105 105 105 
105 105 105 105 105 105 105 105 105 105 105 105 105 105 105 105 12 13 14 15 12 13 14 15 105 105 105 105 105 105 105 105 
105 105 105 105 105 105 105 105 105 105 105 105 105 105 105 105 16 17 18 19 16 17 105 105 105 105 105 105 105 105 105 105 

13 
LADDER 64 0 7 0
LADDER 128 128 7 0
LADDER 416 0 7 0
LADDER 416 128 7 0
DOOR 80 208 1
STONE 160 16 0
STONE 288 144 0
STONE 80 208 0
ENEMY BAMBU 128 16
ENEMY SKELETON 128 80
ENEMY SKELETON 128 208
ENEMY BAMBU 160 208
ENEMY BAMBU 384 208
