32 20
105 105 105 105 105 105 105 105 105 105 105 105 4 5 6 7 4 5 6 7 4 5 6 7 4 5 6 7 4 5 6 7 
105 105 105 105 105 105 105 105 105 105 105 105 8 9 10 11 8 9 10 11 8 9 10 11 8 9 10 11 8 9 10 11 
105 105 105 105 105 105 105 105 105 105 105 105 12 13 14 15 12 13 14 15 12 13 14 15 12 13 14 15 12 13 14 15 
105 105 105 105 105 105 105 105 105 105 105 105 16 17 18 19 105 105 105 105 105 105 105 105 105 105 105 105 105 105 105 105 
105 105 20 21 20 155 156 21 20 21 20 21 4 5 6 7 20 21 20 21 20 21 20 21 20 21 20 21 20 155 156 21 
105 105 10 11 8 157 158 11 8 9 10 11 8 9 10 11 8 9 10 11 8 9 10 11 8 9 10 11 8 157 158 11 
105 105 14 15 12 159 160 15 12 13 14 15 12 13 14 15 12 13 14 15 12 13 14 15 12 13 14 15 12 159 160 15 
105 105 106 106 105 105 105 105 16 17 18 19 105 105 105 105 105 105 105 105 16 17 18 19 105 105 105 105 105 105 105 105 
105 105 20 21 105 105 105 105 4 5 6 7 105 105 105 105 105 105 105 105 4 5 6 7 105 105 105 105 20 21 20 21 
105 105 10 11 105 105 105 105 8 9 10 11 105 105 105 105 105 105 105 105 8 9 10 11 105 105 105 105 8 9 10 11 
105 105 14 15 105 105 105 105 12 13 14 15 105 105 105 105 105 105 105 105 12 13 14 15 105 105 105 105 12 13 14 15 
105 105 18 19 105 105 105 105 16 17 105 105 105 105 105 105 105 105 105 105 105 105 18 19 105 105 105 105 105 105 105 105 
105 105 6 7 20 21 20 21 4 5 20 21 20 21 20 21 20 21 20 21 20 21 6 7 20 21 20 21 20 155 156 21 
105 105 10 11 8 9 10 11 8 9 10 11 8 9 10 11 8 9 10 11 8 9 10 11 8 9 10 11 8 157 158 11 
105 105 14 15 12 13 14 15 12 13 14 15 12 13 14 15 12 13 14 15 12 13 14 15 12 13 14 15 12 159 160 15 
105 105 105 105 105 105 105 105 105 105 105 105 105 105 105 105 16 17 18 19 105 105 105 105 105 105 105 105 105 105 105 105 
105 105 105 105 105 105 105 105 105 105 105 105 20 21 20 21 4 5 6 7 105 105 105 105 105 105 105 105 105 105 105 105 
105 105 105 105 105 105 105 105 105 105 105 105 8 9 10 11 8 9 10 11 105 105 105 105 105 105 105 105 105 105 105 105 
105 105 105 105 105 105 105 105 105 105 105 105 12 13 14 15 12 13 14 15 105 105 105 105 105 105 105 105 105 105 105 105 
105 105 105 105 105 105 105 105 105 105 105 105 16 17 18 19 105 105 105 105 105 105 105 105 105 105 105 105 105 105 105 105 

8 
LADDER 32 128 7 0
STONE 192 208 0
STONE 288 80 0
WDOOR 384 64 2
ENEMY SKELETON 80 80
ENEMY SKELETON 128 208
ENEMY SKELETON 240 80
ENEMY SKELETON 368 16
