32 20
127 128 127 128 127 128 127 128 127 128 127 128 127 128 127 128 127 128 127 128 127 128 127 128 127 128 127 128 127 128 125 125 
129 130 129 130 129 130 129 130 129 130 129 130 129 130 129 130 129 130 129 130 129 130 129 130 129 130 129 130 129 130 125 125 
128 127 128 127 128 127 128 127 128 127 128 127 128 127 128 127 128 127 128 127 128 127 128 127 128 127 128 127 128 127 125 125 
125 125 125 125 125 125 125 125 125 125 125 125 125 125 125 125 125 125 125 125 125 125 125 125 125 125 125 125 125 125 125 125 
125 125 131 132 131 135 136 132 131 132 131 132 131 132 131 132 131 132 131 132 131 132 131 132 131 132 131 132 131 132 125 125 
125 125 129 130 129 137 138 130 129 130 129 130 129 130 129 130 129 130 129 130 129 130 129 130 129 130 129 130 129 130 125 125 
125 125 128 127 128 139 140 127 128 127 128 127 128 127 128 127 128 127 128 127 128 127 128 127 128 127 128 127 128 127 125 125 
125 125 125 125 125 125 125 125 125 125 125 125 125 125 125 125 130 129 130 129 125 125 125 125 125 125 125 125 125 125 125 125 
125 125 125 125 131 132 131 132 131 135 136 132 131 132 131 132 127 128 127 128 125 125 125 125 125 125 125 125 125 125 125 125 
125 125 125 125 129 130 129 130 129 137 138 130 129 130 129 130 129 130 129 130 125 125 125 125 125 125 125 125 125 125 125 125 
125 125 125 125 128 127 128 127 128 139 140 127 128 127 128 127 128 127 128 127 125 125 125 125 125 125 125 125 125 125 125 125 
125 125 125 125 130 129 130 129 125 125 125 125 125 126 126 125 125 125 125 125 125 125 125 125 125 125 125 125 125 125 125 125 
125 125 125 125 127 128 127 128 131 132 131 132 131 128 131 132 125 125 125 125 125 125 125 125 125 125 125 125 125 125 125 125 
125 125 125 125 129 130 129 130 129 130 129 130 129 130 129 130 125 125 125 125 125 125 125 125 125 125 125 125 125 125 125 125 
125 125 125 125 128 127 128 127 128 127 128 127 128 127 128 127 125 125 125 125 125 125 125 125 125 125 125 125 125 125 125 125 
125 125 125 125 130 129 130 129 130 129 130 129 130 129 130 129 125 125 125 125 125 125 125 125 125 125 125 125 125 125 125 125 
131 132 131 132 127 128 127 128 127 128 127 128 127 128 127 128 131 132 131 132 131 135 136 132 131 132 131 132 131 132 125 125 
129 130 129 130 129 130 129 130 129 130 129 130 129 130 129 130 129 130 129 130 129 137 138 130 129 130 129 130 129 130 125 125 
128 127 128 127 128 127 128 127 128 127 128 127 128 127 128 127 128 127 128 127 128 139 140 127 128 127 128 127 128 127 125 125 
125 125 125 125 125 125 125 125 130 129 130 129 125 125 125 125 125 125 125 125 125 125 125 125 125 125 125 125 125 125 125 125 

7 
LADDER 208 192 7 0
TOMB 208 80
ENEMY JUMPINGBUSH 96 272
ENEMY JUMPINGBUSH 96 80
ENEMY JUMPINGBUSH 256 144
ENEMY JUMPINGBUSH 416 80
WITEM 208 16 2
