32 20
125 125 127 128 127 128 127 128 127 128 127 128 127 128 127 128 127 128 127 128 127 128 127 128 127 128 127 128 127 128 125 125 
125 125 129 130 129 130 129 130 129 130 129 130 129 130 129 130 129 130 129 130 129 130 129 130 129 130 129 130 129 130 125 125 
125 125 128 127 128 127 128 127 128 127 128 127 128 127 128 127 128 127 128 127 128 127 128 127 128 127 128 127 128 127 125 125 
125 125 130 129 125 125 125 125 125 125 125 125 130 129 130 129 130 129 130 129 130 129 130 129 125 125 125 125 125 125 125 125 
125 125 127 128 131 132 131 132 131 132 131 132 127 128 127 128 127 128 127 128 127 128 127 128 131 132 131 132 131 132 125 125 
125 125 129 130 129 130 129 130 129 130 129 130 129 130 129 130 129 130 129 130 129 130 129 130 129 130 129 130 129 130 125 125 
125 125 128 127 128 127 128 127 128 127 128 127 128 127 128 127 128 127 128 127 128 127 128 127 128 127 128 127 128 127 125 125 
125 125 125 125 125 125 126 126 130 129 130 129 130 129 130 129 130 129 130 129 125 125 125 125 125 125 125 125 130 129 125 125 
125 125 131 132 131 132 131 132 127 128 127 128 127 128 127 128 127 128 127 128 131 132 131 132 131 135 136 132 127 128 125 125 
125 125 129 130 129 130 129 130 129 130 129 130 129 130 129 130 129 130 129 130 129 130 129 130 129 137 138 130 129 130 125 125 
125 125 128 127 128 127 128 127 128 127 128 127 128 127 128 127 128 127 128 127 128 127 128 127 128 139 140 127 128 127 125 125 
125 125 130 129 130 129 125 125 125 125 125 125 130 129 130 129 130 129 130 129 130 129 126 126 125 125 125 125 125 125 125 125 
125 125 127 128 127 128 131 132 131 135 136 132 127 128 127 128 127 128 127 128 127 128 131 132 131 132 131 132 131 132 125 125 
125 125 129 130 129 130 129 130 129 137 138 130 129 130 129 130 129 130 129 130 129 130 129 130 129 130 129 130 129 130 125 125 
125 125 128 127 128 127 128 127 128 139 140 127 128 127 128 127 128 127 128 127 128 127 128 127 128 127 128 127 128 127 125 125 
125 125 125 125 125 125 125 125 125 125 125 125 130 129 130 129 130 129 130 129 130 129 130 129 130 129 130 129 130 129 125 125 
125 125 131 132 131 132 131 132 131 132 131 132 127 128 127 128 127 128 127 128 127 128 127 128 127 128 127 128 127 128 125 125 
125 125 129 130 129 130 129 130 129 130 129 130 129 130 129 130 129 130 129 130 129 130 129 130 129 130 129 130 129 130 125 125 
125 125 128 127 128 127 128 127 128 127 128 127 128 127 128 127 128 127 128 127 128 127 128 127 128 127 128 127 128 127 125 125 
125 125 130 129 125 125 125 125 125 125 125 125 125 125 125 125 125 125 125 125 125 125 125 125 125 125 125 125 125 125 125 125 

9 
LADDER 96 128 3 0
LADDER 352 192 7 0
LADDER 416 0 3 0
ENEMY JUMPINGBUSH 384 16
ENEMY JUMPINGBUSH 416 144
ENEMY JUMPINGBUSH 128 16
ENEMY JUMPINGBUSH 96 272
ENEMY JUMPINGBUSH 256 272
TOMB 80 16
