32 20
127 128 127 128 127 128 127 128 127 128 127 128 125 125 125 125 125 125 125 125 125 125 127 128 127 128 127 128 127 128 126 126 
129 130 129 130 129 130 129 130 129 130 129 130 125 125 125 125 125 125 125 125 125 125 129 130 129 130 129 130 129 130 126 126 
128 127 128 127 128 127 128 127 128 127 128 127 125 125 125 125 125 125 125 125 125 125 128 127 128 127 128 127 128 127 126 126 
125 125 130 129 130 129 130 129 130 129 130 129 125 125 125 125 125 125 125 125 125 125 130 129 130 129 130 129 130 129 126 126 
125 125 127 128 127 128 127 128 127 128 127 128 131 132 131 132 131 135 136 132 131 132 127 128 127 128 127 128 127 128 126 126 
125 125 129 130 129 130 129 130 129 130 129 130 129 130 129 130 129 137 138 130 129 130 129 130 129 130 129 130 129 130 126 126 
125 125 128 127 128 127 128 127 128 127 128 127 128 127 128 127 128 139 140 127 128 127 128 127 128 127 128 127 128 127 126 126 
125 125 130 129 130 129 130 129 130 129 130 129 130 129 130 129 125 125 125 125 125 125 125 125 130 129 130 129 130 129 126 126 
125 125 127 128 127 128 127 128 127 128 127 128 127 128 127 128 131 132 131 132 131 132 131 132 127 128 127 128 127 128 126 126 
125 125 129 130 129 130 129 130 129 130 129 130 129 130 129 130 129 130 129 130 129 130 129 130 129 130 129 130 129 130 126 126 
125 125 128 127 128 127 128 127 128 127 128 127 128 127 128 127 128 127 128 127 128 127 128 127 128 127 128 127 128 127 126 126 
125 125 125 125 125 125 125 125 130 129 130 129 130 129 130 129 130 129 130 129 130 129 130 129 130 129 130 129 130 129 126 126 
125 125 131 132 131 132 131 132 127 128 127 128 127 128 127 128 127 128 127 128 127 128 127 128 127 128 127 128 127 128 126 126 
125 125 129 130 129 130 129 130 129 130 129 130 129 130 129 130 129 130 129 130 129 130 129 130 129 130 129 130 129 130 126 126 
125 125 128 127 128 127 128 127 128 127 128 127 128 127 128 127 128 127 128 127 128 127 128 127 128 127 128 127 128 127 126 126 
126 126 126 126 126 126 126 126 126 126 126 126 126 126 126 126 126 126 126 126 126 126 126 126 126 126 126 126 126 126 126 126 
131 132 131 132 131 132 131 132 131 132 131 132 131 132 131 132 131 132 131 132 131 132 131 132 131 132 131 132 131 132 131 132 
129 130 129 130 129 130 129 130 129 130 129 130 129 130 129 130 129 130 129 130 129 130 129 130 129 130 129 130 129 130 129 130 
128 127 128 127 128 127 128 127 128 127 128 127 128 127 128 127 128 127 128 127 128 127 128 127 128 127 128 127 128 127 128 127 
130 129 130 129 130 129 130 129 130 129 130 129 130 129 130 129 130 129 130 129 130 129 130 129 130 129 130 129 130 129 130 129 

5 
LADDER 64 0 11 0
LADDER 160 0 15 0
LADDER 416 0 15 0
LADDER 240 256 5 0
WITEM 304 80 3
