32 20
125 125 127 128 127 128 127 128 127 128 127 128 127 128 127 128 127 128 127 128 127 128 127 128 127 128 127 128 127 128 125 125 
125 125 129 130 129 130 129 130 129 130 129 130 129 130 129 130 129 130 129 130 129 130 129 130 129 130 129 130 129 130 125 125 
125 125 128 127 128 127 128 127 128 127 128 127 128 127 128 127 128 127 128 127 128 127 128 127 128 127 128 127 128 127 125 125 
125 125 125 125 125 125 125 125 125 125 125 125 125 125 125 125 125 125 125 125 125 125 125 125 125 125 125 125 125 125 125 125 
125 125 131 132 131 132 131 132 131 135 136 132 131 132 131 132 131 132 131 132 131 135 136 132 131 132 131 132 131 132 125 125 
125 125 129 130 129 130 129 130 129 137 138 130 129 130 129 130 129 130 129 130 129 137 138 130 129 130 129 130 129 130 125 125 
125 125 128 127 128 127 128 127 128 139 140 127 128 127 128 127 128 127 128 127 128 139 140 127 128 127 128 127 128 127 125 125 
125 125 125 125 126 126 125 125 125 125 125 125 125 125 125 125 125 125 125 125 125 125 125 125 125 125 125 125 125 125 125 125 
125 125 131 132 131 132 131 132 131 132 131 132 131 135 136 132 131 132 131 132 131 132 131 132 131 132 131 132 131 132 125 125 
125 125 129 130 129 130 129 130 129 130 129 130 129 137 138 130 129 130 129 130 129 130 129 130 129 130 129 130 129 130 125 125 
125 125 128 127 128 127 128 127 128 127 128 127 128 139 140 127 128 127 128 127 128 127 128 127 128 127 128 127 128 127 125 125 
125 125 125 125 125 125 125 125 125 125 125 125 125 125 125 125 125 125 125 125 125 125 125 125 125 125 126 126 125 125 125 125 
125 125 131 132 131 132 131 132 131 135 136 132 131 132 131 132 131 132 131 132 131 135 136 132 131 132 131 132 131 132 125 125 
125 125 129 130 129 130 129 130 129 137 138 130 129 130 129 130 129 130 129 130 129 137 138 130 129 130 129 130 129 130 125 125 
125 125 128 127 128 127 128 127 128 139 140 127 128 127 128 127 128 127 128 127 128 139 140 127 128 127 128 127 128 127 125 125 
125 125 125 125 126 126 125 125 125 125 125 125 125 125 125 125 125 125 125 125 125 125 125 125 125 125 125 125 125 125 125 125 
125 125 131 132 131 132 131 132 131 132 131 132 131 135 136 132 131 132 131 132 131 132 131 132 131 132 131 132 131 132 125 125 
125 125 129 130 129 130 129 130 129 130 129 130 129 137 138 130 129 130 129 130 129 130 129 130 129 130 129 130 129 130 125 125 
125 125 128 127 128 127 128 127 128 127 128 127 128 139 140 127 128 127 128 127 128 127 128 127 128 127 128 127 128 127 125 125 
125 125 125 125 125 125 125 125 125 125 125 125 125 125 125 125 130 129 130 129 125 125 125 125 125 125 125 125 125 125 125 125 

8 
LADDER 64 256 3 0
LADDER 64 128 3 0
LADDER 416 192 3 0
ENEMY WHITEBEAR 144 144
ENEMY WHITEBEAR 144 272
ENEMY WHITEBEAR 336 208
ENEMY WHITEBEAR 384 144
WITEM 96 16 1
