32 20
125 125 125 125 127 128 127 128 127 128 127 128 127 128 127 128 125 125 125 125 127 128 127 128 127 128 127 128 127 128 127 128 
125 125 125 125 129 130 129 130 129 130 129 130 129 130 129 130 125 125 125 125 129 130 129 130 129 130 129 130 129 130 129 130 
125 125 125 125 128 127 128 127 128 127 128 127 128 127 128 127 125 125 125 125 128 127 128 127 128 127 128 127 128 127 128 127 
125 125 125 125 125 126 126 126 125 125 125 125 125 125 125 125 125 125 125 125 130 129 130 129 130 129 130 129 130 129 125 125 
125 125 125 125 131 132 131 132 131 132 131 132 131 132 131 132 131 132 131 132 127 128 127 128 127 128 127 128 127 128 125 125 
125 125 125 125 129 130 129 130 129 130 129 130 129 130 129 130 129 130 129 130 129 130 129 130 129 130 129 130 129 130 125 125 
125 125 125 125 128 127 128 127 128 127 128 127 128 127 128 127 128 127 128 127 128 127 128 127 128 127 128 127 128 127 125 125 
125 125 125 125 130 129 130 129 130 129 130 129 130 129 125 125 125 125 130 129 130 129 125 125 126 126 125 125 130 129 125 125 
125 125 125 125 127 128 127 128 127 128 127 128 127 128 125 125 125 125 127 128 127 128 131 132 131 132 131 132 127 128 125 125 
125 125 125 125 129 130 129 130 129 130 129 130 129 130 125 125 125 125 129 130 129 130 129 130 129 130 129 130 129 130 125 125 
125 125 125 125 128 127 128 127 128 127 128 127 128 127 125 125 125 125 128 127 128 127 128 127 128 127 128 127 128 127 125 125 
125 125 125 125 125 125 125 125 130 129 130 129 125 125 125 125 125 125 125 125 130 129 130 129 125 125 125 125 125 125 125 125 
125 125 125 125 131 132 131 132 127 128 127 128 131 132 131 132 131 132 131 132 127 128 127 128 131 132 131 132 131 132 125 125 
125 125 125 125 129 130 129 130 129 130 129 130 129 130 129 130 129 130 129 130 129 130 129 130 129 130 129 130 129 130 125 125 
125 125 125 125 128 127 128 127 128 127 128 127 128 127 128 127 128 127 128 127 128 127 128 127 128 127 128 127 128 127 125 125 
125 125 125 125 130 129 130 125 125 125 125 126 126 125 125 125 125 125 125 129 130 129 130 129 130 129 125 125 125 125 125 125 
125 125 125 125 127 128 127 128 131 132 131 132 131 132 131 132 131 132 131 128 127 128 127 128 127 128 131 132 131 132 125 125 
125 125 125 125 129 130 129 130 129 130 129 130 129 130 129 130 129 130 129 130 129 130 129 130 129 130 129 130 129 130 125 125 
125 125 125 125 128 127 128 127 128 127 128 127 128 127 128 127 128 127 128 127 128 127 128 127 128 127 128 127 128 127 125 125 
125 125 125 125 125 125 125 125 125 125 125 125 125 125 125 129 130 129 130 125 125 125 125 125 125 125 125 125 125 125 125 125 

14 
LADDER 384 128 3 0
LADDER 96 64 7 0
LADDER 176 256 3 0
TOMB 80 16
ITEM 208 16 5
HITWALL 192 0 32
ENEMY WITCH 96 144
ENEMY WITCH 288 144
ENEMY WITCH 96 16
ENEMY WITCH 352 80
ENEMY WITCH 352 272
ENEMY WITCH 224 208
ENEMY WITCH 272 208
ENEMY WITCH 112 208
