32 20
125 125 127 128 127 128 127 128 127 128 127 128 127 128 127 128 127 128 127 128 127 128 127 128 127 128 127 128 125 125 125 125 
125 125 129 130 129 130 129 130 129 130 129 130 129 130 129 130 129 130 129 130 129 130 129 130 129 130 129 130 125 125 125 125 
125 125 128 127 128 127 128 127 128 127 128 127 128 127 128 127 128 127 128 127 128 127 128 127 128 127 128 127 125 125 125 125 
125 125 125 125 125 125 125 125 125 125 125 125 125 125 125 126 126 126 125 125 125 125 125 125 125 125 125 125 125 125 125 125 
125 125 131 132 131 135 136 132 131 132 131 132 125 125 125 132 131 132 131 132 131 132 131 132 131 135 136 132 125 125 125 125 
125 125 129 130 129 137 138 130 129 130 129 130 125 125 125 130 129 130 129 130 129 130 129 130 129 137 138 130 125 125 125 125 
125 125 128 127 128 139 140 127 128 127 128 127 125 125 125 127 128 127 128 127 128 127 128 127 128 139 140 127 125 125 125 125 
125 125 130 129 125 125 125 125 125 125 125 125 125 125 125 126 126 126 125 125 125 125 125 125 125 125 125 125 125 125 125 125 
125 125 127 128 131 132 131 132 131 132 131 132 131 132 131 132 131 125 125 125 125 125 125 125 125 125 125 125 125 125 125 125 
125 125 129 130 129 130 129 130 129 130 129 130 129 130 129 130 129 125 125 125 125 125 125 125 125 125 125 125 125 125 125 125 
125 125 128 127 128 127 128 127 128 127 128 127 128 127 128 127 128 125 125 125 125 125 125 125 125 125 125 125 125 125 125 125 
125 125 125 125 125 125 125 125 130 129 130 129 130 129 130 129 130 125 125 125 125 125 125 125 125 125 125 125 125 125 125 125 
125 125 125 125 125 125 125 125 127 128 127 128 127 128 127 128 127 132 131 132 131 135 136 132 131 132 131 132 125 125 125 125 
125 125 125 125 125 125 125 125 129 130 129 130 129 130 129 130 129 130 129 130 129 137 138 130 129 130 129 130 125 125 125 125 
125 125 125 125 125 125 125 125 128 127 128 127 128 127 128 127 128 127 128 127 128 139 140 127 128 127 128 127 125 125 125 125 
125 125 125 125 125 125 125 125 125 125 125 125 125 125 125 126 126 126 125 125 125 125 125 125 125 125 125 125 125 125 125 125 
125 125 125 125 125 125 125 125 131 132 131 132 131 132 131 132 131 132 131 132 131 132 131 132 131 132 131 132 131 135 136 132 
125 125 125 125 125 125 125 125 129 130 129 130 129 130 129 130 129 130 129 130 129 130 129 130 129 130 129 130 129 137 138 130 
125 125 125 125 125 125 125 125 128 127 128 127 128 127 128 127 128 127 128 127 128 127 128 127 128 127 128 127 128 139 140 127 
125 125 125 125 125 125 125 125 125 125 125 125 125 125 125 125 125 125 125 125 125 125 125 125 125 125 125 125 125 125 125 125 

10 
LADDER 240 256 3 0
LADDER 240 128 7 0
LADDER 240 64 3 0
LADDER 240 0 3 0
WNOKEYDOOR2 384 256
ENEMY JUMPINGBUSH 160 208
ENEMY JUMPINGBUSH 192 16
ENEMY JUMPINGBUSH 384 16
ENEMY JUMPINGBUSH 416 272
WITEM 112 80 1
