32 20
125 125 125 125 125 125 125 125 125 125 125 125 127 128 127 128 127 128 127 128 127 128 127 128 127 128 127 128 127 128 125 125 
125 125 125 125 125 125 125 125 125 125 125 125 129 130 129 130 129 130 129 130 129 130 129 130 129 130 129 130 129 130 125 125 
125 125 125 125 125 125 125 125 125 125 125 125 128 127 128 127 128 127 128 127 128 127 128 127 128 127 128 127 128 127 125 125 
125 125 125 125 125 125 125 125 125 125 125 125 126 126 125 125 125 125 125 125 125 125 125 125 125 125 125 125 125 125 125 125 
131 132 131 132 131 132 131 132 131 132 131 132 131 132 131 132 131 132 131 132 131 135 136 132 131 132 131 132 131 132 125 125 
129 130 129 130 129 130 129 130 129 130 129 130 129 130 129 130 129 130 129 130 129 137 138 130 129 130 129 130 129 130 125 125 
128 127 128 127 128 127 128 127 128 127 128 127 128 127 128 127 128 127 128 127 128 139 140 127 128 127 128 127 128 127 125 125 
125 125 125 125 130 129 125 125 125 125 125 125 125 125 125 125 125 125 125 125 125 125 125 125 125 125 125 125 126 126 125 125 
125 125 125 125 127 128 125 125 131 132 131 132 131 132 131 132 131 132 131 132 131 132 131 132 131 132 131 132 131 132 125 125 
125 125 125 125 129 130 125 125 129 130 129 130 129 130 129 130 129 130 129 130 129 130 129 130 129 130 129 130 129 130 125 125 
125 125 125 125 128 127 125 125 128 127 128 127 128 127 128 127 128 127 128 127 128 127 128 127 128 127 128 127 128 127 125 125 
125 125 125 125 130 129 125 125 126 126 125 125 125 125 125 125 125 125 126 126 125 125 125 125 125 125 125 125 125 125 125 125 
125 125 125 125 127 128 125 125 131 132 131 132 131 132 131 132 131 132 131 132 131 132 131 132 131 135 136 132 131 132 125 125 
125 125 125 125 129 130 125 125 129 130 129 130 129 130 129 130 129 130 129 130 129 130 129 130 129 137 138 130 129 130 125 125 
125 125 125 125 128 127 125 125 128 127 128 127 128 127 128 127 128 127 128 127 128 127 128 127 128 139 140 127 128 127 125 125 
125 125 125 125 130 129 125 125 125 125 125 125 125 125 125 125 126 126 125 125 125 125 125 125 125 125 125 125 126 126 125 125 
125 125 125 125 127 128 131 132 131 132 131 132 131 132 131 132 131 132 131 132 131 135 136 132 131 132 131 132 131 132 125 125 
125 125 125 125 129 130 129 130 129 130 129 130 129 130 129 130 129 130 129 130 129 137 138 130 129 130 129 130 129 130 125 125 
125 125 125 125 128 127 128 127 128 127 128 127 128 127 128 127 128 127 128 127 128 139 140 127 128 127 128 127 128 127 125 125 
125 125 125 125 125 125 125 125 125 125 125 125 125 125 125 125 125 125 125 125 125 125 125 125 125 125 125 125 125 125 125 125 

13 
LADDER 128 192 3 0
TOMB 144 144
WNOKEYDOOR2 144 64
LADDER 192 64 3 0
WNOKEYDOOR 240 128
WNOKEYDOOR 160 256
LADDER 256 256 3 0
LADDER 288 192 3 0
LADDER 448 128 3 0
LADDER 448 256 3 0
WNOKEYDOOR 352 0
LADDER 416 0 3 0
ENEMY MEGABAT 336 0

