32 20
127 128 127 128 127 128 127 128 127 128 127 128 125 125 125 128 127 125 125 125 127 128 127 128 127 128 127 128 127 128 125 125 
129 130 129 130 129 130 129 130 129 130 129 130 125 125 125 130 129 125 125 125 129 130 129 130 129 130 129 130 129 130 125 125 
128 127 128 127 128 127 128 127 128 127 128 127 125 125 125 127 128 125 125 125 128 127 128 127 128 127 128 127 128 127 125 125 
125 125 125 125 125 125 125 125 130 129 130 129 125 125 125 129 130 125 125 125 125 125 125 125 125 125 125 125 130 129 125 125 
131 132 131 132 131 132 131 132 127 128 127 128 125 125 125 128 127 125 125 125 131 132 131 132 131 135 136 132 127 128 125 125 
129 130 129 130 129 130 129 130 129 130 129 130 125 125 125 130 129 125 125 125 129 130 129 130 129 137 138 130 129 130 125 125 
128 127 128 127 128 127 128 127 128 127 128 127 125 125 125 127 128 125 125 125 128 127 128 127 128 139 140 127 128 127 125 125 
125 125 125 125 125 125 126 126 130 129 130 129 125 125 125 129 130 125 125 125 130 129 130 129 125 125 125 125 125 125 125 125 
131 132 131 132 131 132 131 132 127 128 127 128 125 125 125 128 127 125 125 125 127 128 127 128 131 132 131 132 125 125 125 125 
129 130 129 130 129 130 129 130 129 130 129 130 125 125 125 130 129 125 125 125 129 130 129 130 129 130 129 130 125 125 125 125 
128 127 128 127 128 127 128 127 128 127 128 127 125 125 125 127 128 125 125 125 128 127 128 127 128 127 128 127 125 125 125 125 
130 129 130 129 130 129 130 129 130 129 130 129 125 125 125 129 130 125 125 125 125 125 126 126 130 129 130 129 125 125 125 125 
127 128 127 128 127 128 127 128 127 128 127 128 125 125 125 128 127 125 125 125 131 132 131 132 127 128 127 128 131 132 125 125 
129 130 129 130 129 130 129 130 129 130 129 130 125 125 125 130 129 125 125 125 129 130 129 130 129 130 129 130 129 130 125 125 
128 127 128 127 128 127 128 127 128 127 128 127 125 125 125 127 128 125 125 125 128 127 128 127 128 127 128 127 128 127 125 125 
125 125 125 125 125 125 125 125 125 125 126 126 125 125 125 129 130 125 125 125 130 129 130 129 130 129 130 129 130 129 125 125 
131 132 131 132 131 132 131 132 131 132 131 132 125 125 125 128 127 125 125 125 127 128 127 128 127 128 127 128 127 128 125 125 
129 130 129 130 129 130 129 130 129 130 129 130 125 125 125 130 129 125 125 125 129 130 129 130 129 130 129 130 129 130 125 125 
128 127 128 127 128 127 128 127 128 127 128 127 125 125 125 127 128 125 125 125 128 127 128 127 128 127 128 127 128 127 125 125 
130 129 130 129 130 129 130 129 130 129 130 129 125 125 125 129 130 125 125 125 130 129 130 129 130 129 125 125 125 125 125 125 

11 
LADDER 352 192 9 0
LADDER 400 0 3 0
LADDER 240 0 21 0
LADDER 96 0 3 0
LADDER 96 128 7 0
LADDER 160 256 5 0
TOMB 80 80
ENEMY CHICKEN 96 80
ENEMY CHICKEN 160 208
ENEMY CHICKEN 448 80
ENEMY CHICKEN 416 16
