32 20
127 128 127 128 127 128 127 128 127 128 127 128 125 125 125 128 127 125 125 125 127 128 127 128 127 128 127 128 127 128 127 128 
129 130 129 130 129 130 129 130 129 130 129 130 125 125 125 130 129 125 125 125 129 130 129 130 129 130 129 130 129 130 129 130 
128 127 128 127 128 127 128 127 128 127 128 127 125 125 125 127 128 125 125 125 128 127 128 127 128 127 128 127 128 127 128 127 
130 129 130 129 130 129 130 129 130 129 130 129 125 125 125 129 130 125 125 125 130 129 130 129 130 129 125 125 125 125 125 125 
127 128 127 128 127 128 127 128 127 128 127 128 125 125 125 128 127 125 125 125 127 128 127 128 127 128 131 132 132 135 136 132 
129 130 129 130 129 130 129 130 129 130 129 130 125 125 125 130 129 125 125 125 129 130 129 130 129 130 129 130 129 137 138 130 
128 127 128 127 128 127 128 127 128 127 128 127 125 125 125 127 128 125 125 125 128 127 128 127 128 127 128 127 128 139 140 127 
130 129 130 129 125 125 125 125 125 125 125 125 125 125 125 129 130 125 125 125 125 125 125 125 125 125 125 125 125 125 125 125 
127 128 127 128 131 132 131 132 131 132 131 132 125 125 125 128 127 125 125 125 131 132 131 132 131 135 136 132 131 132 131 132 
129 130 129 130 129 130 129 130 129 130 129 130 125 125 125 130 129 125 125 125 129 130 129 130 129 137 138 130 129 130 129 130 
128 127 128 127 128 127 128 127 128 127 128 127 125 125 125 127 128 125 125 125 128 127 128 127 128 139 140 127 128 127 128 127 
125 125 125 125 125 125 125 125 130 129 130 129 125 125 125 129 130 125 125 125 130 129 130 129 125 125 125 125 125 125 125 125 
131 135 136 132 131 132 131 132 127 128 127 128 125 125 125 128 127 125 125 125 127 128 127 128 131 132 131 132 131 135 136 132 
129 137 138 130 129 130 129 130 129 130 129 130 125 125 125 130 129 125 125 125 129 130 129 130 129 130 129 130 129 137 138 130 
128 139 140 127 128 127 128 127 128 127 128 127 125 125 125 127 128 125 125 125 128 127 128 127 128 127 128 127 128 139 140 127 
125 125 125 125 125 125 125 125 125 125 125 125 125 125 125 129 130 125 125 125 125 125 125 125 125 125 125 125 125 125 125 125 
125 125 125 125 125 125 125 125 125 125 125 125 125 125 125 128 127 125 125 125 125 125 125 125 125 125 125 125 125 125 125 125 
125 125 125 125 125 125 125 125 125 125 125 125 125 125 125 130 129 125 125 125 125 125 125 125 125 125 125 125 125 125 125 125 
125 125 125 125 125 125 125 125 125 125 125 125 125 125 125 127 128 125 125 125 125 125 125 125 125 125 125 125 125 125 125 125 
125 125 125 125 125 125 125 125 125 125 125 125 125 125 125 129 130 125 125 125 125 125 125 125 125 125 125 125 125 125 125 125 

9 
LADDER 160 0 7 0
LADDER 240 0 21 0
LADDER 352 0 7 0
TOMB 80 144
ENEMY ROCKMAN 96 208
ENEMY ROCKMAN 320 208
ENEMY ROCKMAN 384 144
ENEMY ROCKMAN 320 80
ENEMY ROCKMAN 96 80
