32 20
127 128 127 128 127 128 127 128 127 128 127 128 127 128 127 128 127 128 127 128 127 128 127 128 127 128 127 128 127 128 127 128 
129 130 129 130 129 130 129 130 129 130 129 130 129 130 129 130 129 130 129 130 129 130 129 130 129 130 129 130 129 130 129 130 
128 127 128 127 128 127 128 127 128 127 128 127 128 127 128 127 128 127 128 127 128 127 128 127 128 127 128 127 128 127 128 127 
130 129 130 129 130 129 130 129 125 125 126 126 125 125 125 125 125 125 125 125 125 125 125 125 130 129 130 129 130 129 130 129 
127 128 127 128 127 128 127 128 131 132 131 132 131 132 131 132 131 132 131 132 131 132 131 132 127 128 127 128 127 128 127 128 
129 130 129 130 129 130 129 130 129 130 129 130 129 130 129 130 129 130 129 130 129 130 129 130 129 130 129 130 129 130 129 130 
128 127 128 127 128 127 128 127 128 127 128 127 128 127 128 127 128 127 128 127 128 127 128 127 128 127 128 127 128 127 128 127 
130 129 130 129 125 125 125 125 125 125 125 125 130 129 130 129 130 129 130 129 126 126 125 125 125 125 125 125 130 129 130 129 
127 128 127 128 131 135 136 132 131 132 131 132 127 128 127 128 127 128 127 128 131 132 131 132 131 135 136 132 127 128 127 128 
129 130 129 130 129 137 138 130 129 130 129 130 129 130 129 130 129 130 129 130 129 130 129 130 129 137 138 130 129 130 129 130 
128 127 128 127 128 139 140 127 128 127 128 127 128 127 128 127 128 127 128 127 128 127 128 127 128 139 140 127 128 127 128 127 
125 125 125 125 125 125 125 125 125 125 125 125 125 125 125 126 126 125 125 125 125 125 125 125 125 125 125 125 125 125 125 125 
125 125 125 125 125 125 125 125 125 125 125 125 125 125 125 132 131 125 125 125 125 125 125 125 125 125 125 125 125 125 125 125 
125 125 125 125 125 125 125 125 125 125 125 125 125 125 125 130 129 125 125 125 125 125 125 125 125 125 125 125 125 125 125 125 
125 125 125 125 125 125 125 125 125 125 125 125 125 125 125 127 128 125 125 125 125 125 125 125 125 125 125 125 125 125 125 125 
125 125 125 125 125 125 125 125 125 125 125 125 125 125 125 129 130 125 125 125 125 125 125 125 125 125 125 125 125 125 125 125 
131 132 131 132 131 135 136 132 131 132 131 132 125 125 125 128 127 125 125 125 131 132 131 132 131 135 136 132 131 132 131 132 
129 130 129 130 129 137 138 130 129 130 129 130 125 125 125 130 129 125 125 125 129 130 129 130 129 137 138 130 129 130 129 130 
128 127 128 127 128 139 140 127 128 127 128 127 125 125 125 127 128 125 125 125 128 127 128 127 128 139 140 127 128 127 128 127 
125 125 125 125 125 125 125 125 125 125 125 125 125 125 125 129 130 125 125 125 130 129 130 129 125 125 125 125 125 125 125 125 

11 
LADDER 160 64 3 0
LADDER 320 128 3 0
LADDER 240 192 9 0
TOMB 336 16
ENEMY ROCKMAN 192 16
ENEMY ROCKMAN 96 80
ENEMY ROCKMAN 160 272
ENEMY ROCKMAN 384 272
ENEMY ROCKMAN 384 80
ENEMY ROCKMAN 416 144
ENEMY ROCKMAN 192 144
