32 20
125 125 125 125 127 128 127 128 127 128 127 128 127 128 127 128 127 128 127 128 127 128 127 128 127 128 127 128 127 128 127 128 
125 125 125 125 129 130 129 130 129 130 129 130 129 130 129 130 129 130 129 130 129 130 129 130 129 130 129 130 129 130 129 130 
125 125 125 125 128 127 128 127 128 127 128 127 128 127 128 127 128 127 128 127 128 127 128 127 128 127 128 127 128 127 128 127 
125 125 125 125 130 129 125 125 125 125 125 125 130 129 130 129 125 125 125 125 125 125 125 125 130 129 125 125 125 125 125 125 
125 125 125 125 127 128 131 132 131 132 125 125 127 128 127 128 125 125 131 132 131 132 131 132 127 128 131 132 131 132 131 132 
125 125 125 125 129 130 129 130 129 130 125 125 129 130 129 130 125 125 129 130 129 130 129 130 129 130 129 130 129 130 129 130 
125 125 125 125 128 127 128 127 128 127 125 125 128 127 128 127 125 125 128 127 128 127 128 127 128 127 128 127 128 127 128 127 
125 125 125 125 125 125 125 125 130 129 125 125 130 129 130 129 125 125 130 129 130 129 125 125 125 125 130 129 125 125 125 125 
125 125 125 125 125 125 125 125 127 128 131 132 127 128 127 128 131 132 127 128 127 128 125 125 125 125 127 128 125 125 125 125 
125 125 125 125 125 125 125 125 129 130 129 130 129 130 129 130 129 130 129 130 129 130 125 125 125 125 129 130 125 125 125 125 
125 125 125 125 125 125 125 125 128 127 128 127 128 127 128 127 128 127 128 127 128 127 125 125 125 125 128 127 125 125 125 125 
125 125 125 125 125 125 125 125 125 125 125 125 125 125 125 125 130 129 130 129 125 125 125 125 125 125 130 129 125 125 125 125 
125 125 125 125 131 132 131 132 131 132 131 132 131 132 131 132 127 128 127 128 125 125 131 132 131 132 127 128 131 132 131 132 
125 125 125 125 129 130 129 130 129 130 129 130 129 130 129 130 129 130 129 130 125 125 129 130 129 130 129 130 129 130 129 130 
125 125 125 125 128 127 128 127 128 127 128 127 128 127 128 127 128 127 128 127 125 125 128 127 128 127 128 127 128 127 128 127 
125 125 125 125 130 129 125 125 125 125 125 125 125 125 125 125 125 125 125 125 125 125 130 129 125 125 125 125 130 129 130 129 
125 125 125 125 127 128 131 132 131 135 136 132 131 132 131 132 131 132 131 132 131 132 127 128 125 125 125 125 127 128 127 128 
125 125 125 125 129 130 129 130 129 137 138 130 129 130 129 130 129 130 129 130 129 130 129 130 125 125 125 125 129 130 129 130 
125 125 125 125 128 127 128 127 128 139 140 127 128 127 128 127 128 127 128 127 128 127 128 127 125 125 125 125 128 127 128 127 
125 125 125 125 125 125 125 125 125 125 125 125 125 125 125 125 125 125 130 129 130 129 125 125 125 125 125 125 125 125 125 125 

9 
TOMB 224 208
ENEMY OCTOPUS 160 0 0 0
ENEMY OCTOPUS 288 48 0 1
ENEMY OCTOPUS 384 112 0 2
ENEMY OCTOPUS 384 240 0 3
ENEMY OCTOPUS 288 256 1 7
ENEMY OCTOPUS 208 256 0 6
ENEMY OCTOPUS 96 176 0 5
ENEMY OCTOPUS 160 112 0 4
