32 20
125 125 125 125 127 128 127 128 127 128 127 128 127 128 127 128 127 128 127 128 127 128 127 128 127 128 127 128 127 128 125 125 
125 125 125 125 129 130 129 130 129 130 129 130 129 130 129 130 129 130 129 130 129 130 129 130 129 130 129 130 129 130 125 125 
125 125 125 125 128 127 128 127 128 127 128 127 128 127 128 127 128 127 128 127 128 127 128 127 128 127 128 127 128 127 125 125 
125 125 125 125 125 125 125 125 125 125 125 125 125 125 125 125 130 129 125 125 125 125 125 125 125 125 125 125 125 125 125 125 
125 125 125 125 131 132 131 132 131 132 131 132 131 135 136 132 127 128 131 132 131 132 131 132 131 135 136 132 131 132 125 125 
125 125 125 125 129 130 129 130 129 130 129 130 129 137 138 130 129 130 129 130 129 130 129 130 129 137 138 130 129 130 125 125 
125 125 125 125 128 127 128 127 128 127 128 127 128 139 140 127 128 127 128 127 128 127 128 127 128 139 140 127 128 127 125 125 
125 125 125 125 130 129 130 129 125 125 125 126 126 125 125 125 125 125 125 125 130 129 130 129 125 125 125 125 125 125 125 125 
125 125 125 125 127 128 127 128 131 132 131 132 131 132 131 132 131 135 136 132 127 128 127 128 131 132 131 132 125 125 125 125 
125 125 125 125 129 130 129 130 129 130 129 130 129 130 129 130 129 137 138 130 129 130 129 130 129 130 129 130 125 125 125 125 
125 125 125 125 128 127 128 127 128 127 128 127 128 127 128 127 128 139 140 127 128 127 128 127 128 127 128 127 125 125 125 125 
125 125 125 125 125 125 125 125 125 125 125 125 125 125 125 125 125 125 125 125 125 125 125 125 126 126 125 125 125 125 125 125 
125 125 125 125 131 132 131 132 131 135 136 132 131 132 131 132 131 132 131 132 131 132 131 132 131 132 131 132 125 125 125 125 
125 125 125 125 129 130 129 130 129 137 138 130 129 130 129 130 129 130 129 130 129 130 129 130 129 130 129 130 125 125 125 125 
125 125 125 125 128 127 128 127 128 139 140 127 128 127 128 127 128 127 128 127 128 127 128 127 128 127 128 127 125 125 125 125 
125 125 125 125 125 125 125 125 125 125 125 125 125 125 125 125 125 125 125 125 130 129 130 129 125 125 125 125 125 125 125 125 
125 125 125 125 131 132 131 132 131 132 131 132 131 132 131 132 131 135 136 132 127 128 127 128 131 132 131 132 125 125 125 125 
125 125 125 125 129 130 129 130 129 130 129 130 129 130 129 130 129 137 138 130 129 130 129 130 129 130 129 130 125 125 125 125 
125 125 125 125 128 127 128 127 128 127 128 127 128 127 128 127 128 139 140 127 128 127 128 127 128 127 128 127 125 125 125 125 
125 125 125 125 125 125 125 125 130 129 130 129 130 129 130 129 125 125 125 125 125 125 125 125 125 125 125 125 125 125 125 125 

7 
LADDER 448 0 3 0
LADDER 128 0 3 0
LADDER 176 128 3 0
LADDER 384 192 3 0
WKEYDOOR 240 192 1
ENEMY HAIRY 208 144
WITEM 80 208 2
