32 20
125 125 125 125 125 125 125 125 125 125 125 125 125 125 125 125 125 125 125 125 125 125 125 125 125 125 125 125 125 125 125 125 
125 125 125 125 125 125 125 125 125 125 125 125 125 125 125 125 125 125 125 125 125 125 125 125 125 125 125 125 125 125 125 125 
125 125 125 125 125 125 125 125 125 125 125 125 125 125 125 125 125 125 125 125 125 125 125 125 125 125 125 125 125 125 125 125 
125 125 125 125 125 125 125 125 125 125 125 125 125 125 125 125 125 125 125 125 125 125 125 125 125 125 125 125 125 125 125 125 
125 125 125 125 131 132 131 132 131 135 136 132 131 132 131 132 131 135 136 132 131 132 131 132 125 125 125 125 125 125 125 125 
125 125 125 125 129 130 129 130 129 137 138 130 129 130 129 130 129 137 138 130 129 130 129 130 125 125 125 125 125 125 125 125 
125 125 125 125 128 127 128 127 128 139 140 127 128 127 128 127 128 139 140 127 128 127 128 127 125 125 125 125 125 125 125 125 
125 125 125 125 126 126 125 125 125 125 125 125 125 125 125 125 125 125 125 125 125 125 125 125 125 125 125 125 125 125 125 125 
125 125 125 125 131 132 131 132 131 132 131 132 131 135 136 132 131 132 131 132 131 132 131 132 131 132 131 132 131 135 136 132 
125 125 125 125 129 130 129 130 129 130 129 130 129 137 138 130 129 130 129 130 129 130 129 130 129 130 129 130 129 137 138 130 
125 125 125 125 128 127 128 127 128 127 128 127 128 139 140 127 128 127 128 127 128 127 128 127 128 127 128 127 128 139 140 127 
125 125 125 125 130 129 130 129 125 125 125 125 125 125 125 125 125 125 125 125 125 125 125 125 125 125 126 126 125 125 125 125 
125 125 125 125 127 128 127 128 131 132 131 132 131 132 131 132 131 132 131 132 131 132 131 132 131 132 131 132 125 125 125 125 
125 125 125 125 129 130 129 130 129 130 129 130 129 130 129 130 129 130 129 130 129 130 129 130 129 130 129 130 125 125 125 125 
125 125 125 125 128 127 128 127 128 127 128 127 128 127 128 127 128 127 128 127 128 127 128 127 128 127 128 127 125 125 125 125 
125 125 125 125 130 129 130 129 130 129 130 129 130 129 130 129 130 129 130 129 130 129 130 129 130 129 130 129 125 125 125 125 
125 125 125 125 125 125 125 125 125 125 125 125 125 125 125 125 125 125 125 125 125 125 125 125 125 125 125 125 125 125 125 125 
125 125 125 125 125 125 125 125 125 125 125 125 125 125 125 125 125 125 125 125 125 125 125 125 125 125 125 125 125 125 125 125 
125 125 125 125 125 125 125 125 125 125 125 125 125 125 125 125 125 125 125 125 125 125 125 125 125 125 125 125 125 125 125 125 
125 125 125 125 125 125 125 125 125 125 125 125 125 125 125 125 125 125 125 125 125 125 125 125 125 125 125 125 125 125 125 125 

7 
LADDER 416 192 4 0
LADDER 64 128 8 0
WITEM 320 80 0
ENEMY STONEMAN 96 80
ENEMY STONEMAN 256 144
ENEMY STONEMAN 256 224
ENEMY STONEMAN 384 224

BIRDS2
