32 20
125 125 125 125 125 125 125 125 127 128 125 125 125 125 125 125 127 128 127 128 125 125 125 125 125 125 125 125 125 125 125 125 
125 125 125 125 125 125 125 125 129 130 125 125 125 125 125 125 129 130 129 130 125 125 125 125 125 125 125 125 125 125 125 125 
125 125 125 125 125 125 125 125 128 127 125 125 125 125 125 125 128 127 128 127 125 125 125 125 125 125 125 125 125 125 125 125 
125 125 125 125 125 125 125 125 130 129 125 125 125 125 125 125 130 129 130 129 125 125 125 125 125 125 125 125 125 125 125 125 
125 125 125 125 125 125 125 125 127 128 125 125 125 125 125 125 127 128 127 128 125 125 125 125 125 125 125 125 125 125 125 125 
125 125 125 125 125 125 125 125 129 130 125 125 125 125 125 125 129 130 129 130 125 125 125 125 125 125 125 125 125 125 125 125 
125 125 125 125 125 125 125 125 128 127 125 125 125 125 125 125 128 127 128 127 125 125 125 125 125 125 125 125 125 125 125 125 
125 125 125 125 125 125 125 125 130 129 125 125 125 125 125 125 130 129 130 129 125 125 125 125 125 125 125 125 125 125 125 125 
125 125 125 125 125 125 125 125 127 128 125 125 125 125 125 125 127 128 127 128 125 125 125 125 125 125 125 125 125 125 125 125 
125 125 125 125 125 125 125 125 129 130 125 125 125 125 125 125 129 130 129 130 125 125 125 125 125 125 125 125 125 125 125 125 
125 125 125 125 125 125 125 125 128 127 125 125 125 125 125 125 128 127 128 127 125 125 125 125 125 125 125 125 125 125 125 125 
125 125 125 125 125 125 125 125 130 129 125 125 125 125 125 125 130 129 130 129 125 125 125 125 125 125 125 125 125 125 125 125 
125 125 125 125 125 125 125 125 127 128 125 125 125 125 125 125 127 128 127 128 125 125 125 125 125 125 125 125 125 125 125 125 
125 125 125 125 125 125 125 125 129 130 125 125 125 125 125 125 129 130 129 130 125 125 125 125 125 125 125 125 125 125 125 125 
125 125 125 125 125 125 125 125 128 127 125 125 125 125 125 125 128 127 128 127 125 125 125 125 125 125 125 125 125 125 125 125 
125 125 125 125 125 125 125 125 130 129 125 125 125 125 125 125 130 129 130 129 125 125 125 125 125 125 125 125 125 125 125 125 
125 125 125 125 131 132 131 132 127 128 125 125 125 125 125 125 127 128 127 128 125 125 125 125 125 125 125 125 125 125 125 125 
125 125 125 125 129 130 129 130 129 130 125 125 125 125 125 125 129 130 129 130 125 125 125 125 125 125 125 125 125 125 125 125 
125 125 125 125 128 127 128 127 128 127 125 125 125 125 125 125 128 127 128 127 125 125 125 125 125 125 125 125 125 125 125 125 
125 125 125 125 125 125 125 125 130 129 125 125 125 125 125 125 130 129 130 129 125 125 125 125 125 125 125 125 125 125 125 125 

8 
LADDER 128 0 21 0
WITEM 80 272 2
HITWALL 64 256 10
ENEMY BAT 32 64
ENEMY BAT 192 128
ENEMY BAT 32 192
ENEMY BAT 448 192
ENEMY BAT 448 64
