32 20
125 125 127 128 127 128 127 128 127 128 127 128 127 128 127 128 127 128 127 128 127 128 127 128 127 128 127 128 127 128 125 125 
125 125 129 130 129 130 129 130 129 130 129 130 129 130 129 130 129 130 129 130 129 130 129 130 129 130 129 130 129 130 125 125 
125 125 128 127 128 127 128 127 128 127 128 127 128 127 128 127 128 127 128 127 128 127 128 127 128 127 128 127 128 127 125 125 
125 125 130 129 130 129 130 129 126 126 125 125 126 126 130 129 130 129 126 126 125 125 126 126 130 129 130 129 130 129 125 125 
125 125 127 128 127 128 127 128 131 132 131 132 131 132 127 128 127 128 131 132 131 132 131 132 127 128 127 128 127 128 125 125 
125 125 129 130 129 130 129 130 129 130 129 130 129 130 129 130 129 130 129 130 129 130 129 130 129 130 129 130 129 130 125 125 
125 125 128 127 128 127 128 127 128 127 128 127 128 127 128 127 128 127 128 127 128 127 128 127 128 127 128 127 128 127 125 125 
125 125 125 125 126 126 125 125 126 126 130 129 130 129 130 129 130 129 130 129 130 129 126 126 125 125 126 126 125 125 125 125 
125 125 131 132 131 132 131 132 131 132 127 128 127 128 127 128 127 128 127 128 127 128 131 132 131 132 131 132 131 132 125 125 
125 125 129 130 129 130 129 130 129 130 129 130 129 130 129 130 129 130 129 130 129 130 129 130 129 130 129 130 129 130 125 125 
125 125 128 127 128 127 128 127 128 127 128 127 128 127 128 127 128 127 128 127 128 127 128 127 128 127 128 127 128 127 125 125 
125 125 130 129 130 129 130 129 130 129 130 129 126 126 125 125 125 125 126 126 130 129 130 129 130 129 130 129 130 129 125 125 
125 125 127 128 127 128 127 128 127 128 127 128 131 132 131 132 131 132 131 132 127 128 127 128 127 128 127 128 127 128 125 125 
125 125 129 130 129 130 129 130 129 130 129 130 129 130 129 130 129 130 129 130 129 130 129 130 129 130 129 130 129 130 125 125 
125 125 128 127 128 127 128 127 128 127 128 127 128 127 128 127 128 127 128 127 128 127 128 127 128 127 128 127 128 127 125 125 
125 125 125 125 126 126 130 129 126 126 125 125 126 126 130 129 130 129 126 126 125 125 126 126 130 129 126 126 125 125 125 125 
125 125 131 132 131 132 127 128 131 132 131 132 131 132 127 128 127 128 131 132 131 132 131 132 127 128 131 132 131 132 125 125 
125 125 129 130 129 130 129 130 129 130 129 130 129 130 129 130 129 130 129 130 129 130 129 130 129 130 129 130 129 130 125 125 
125 125 128 127 128 127 128 127 128 127 128 127 128 127 128 127 128 127 128 127 128 127 128 127 128 127 128 127 128 127 125 125 
125 125 130 129 125 125 125 125 125 125 125 125 125 125 125 125 125 125 125 125 125 125 125 125 125 125 125 125 130 129 125 125 

18 
LADDER 128 64 3 0
LADDER 192 64 7 0
LADDER 128 128 7 0
LADDER 64 128 7 0
LADDER 64 256 3 0
LADDER 128 256 3 0
LADDER 192 256 3 0
LADDER 192 192 3 0
LADDER 288 192 3 0
LADDER 288 256 3 0
LADDER 288 64 7 0
LADDER 352 64 3 0
LADDER 352 128 7 0
LADDER 416 128 7 0
LADDER 416 256 3 0
LADDER 352 256 3 0
WITEM 192 16 1
ENEMY PLANT 224 208
