32 20
125 125 125 125 125 125 125 125 125 125 125 125 125 125 125 125 127 128 127 128 127 128 127 128 127 128 127 128 127 128 125 125 
125 125 125 125 125 125 125 125 125 125 125 125 125 125 125 125 129 130 129 130 129 130 129 130 129 130 129 130 129 130 125 125 
125 125 125 125 125 125 125 125 125 125 125 125 125 125 125 125 128 127 128 127 128 127 128 127 128 127 128 127 128 127 125 125 
125 125 125 125 125 125 125 125 125 125 125 125 125 125 125 125 130 129 130 129 125 125 125 125 125 125 125 125 125 125 125 125 
131 132 131 132 131 132 131 132 131 135 136 132 131 132 131 132 127 128 127 128 131 135 136 132 125 125 125 125 125 125 125 125 
129 130 129 130 129 130 129 130 129 137 138 130 129 130 129 130 129 130 129 130 129 137 138 130 125 125 125 125 125 125 125 125 
128 127 128 127 128 127 128 127 128 139 140 127 128 127 128 127 128 127 128 127 128 139 140 127 125 125 125 125 125 125 125 125 
130 129 130 129 125 125 125 125 125 125 125 125 130 129 130 129 125 125 125 125 125 125 125 125 125 125 125 125 125 125 125 125 
127 128 127 128 131 135 136 132 131 132 131 132 127 128 127 128 131 132 131 132 131 132 131 132 125 125 125 125 125 125 125 125 
129 130 129 130 129 137 138 130 129 130 129 130 129 130 129 130 129 130 129 130 129 130 129 130 125 125 125 125 125 125 125 125 
128 127 128 127 128 139 140 127 128 127 128 127 128 127 128 127 128 127 128 127 128 127 128 127 125 125 125 125 125 125 125 125 
125 125 125 125 125 125 125 125 130 129 130 129 125 125 125 125 125 125 125 125 130 129 130 129 125 125 125 125 125 125 125 125 
125 125 125 125 131 132 131 132 127 128 127 128 131 132 131 132 131 132 131 132 127 128 127 128 125 125 125 125 125 125 125 125 
125 125 125 125 129 130 129 130 129 130 129 130 129 130 129 130 129 130 129 130 129 130 129 130 125 125 125 125 125 125 125 125 
125 125 125 125 128 127 128 127 128 127 128 127 128 127 128 127 128 127 128 127 128 127 128 127 125 125 125 125 125 125 125 125 
125 125 125 125 130 129 130 129 130 129 130 129 130 129 130 129 130 129 130 129 130 129 130 129 125 125 125 125 125 125 125 125 
125 125 125 125 142 142 142 142 142 142 142 142 142 142 142 142 142 142 142 142 142 142 142 142 125 125 125 125 125 125 125 125 
125 125 125 125 141 141 141 141 141 141 141 141 141 141 141 141 141 141 141 141 141 141 141 141 125 125 125 125 125 125 125 125 
125 125 125 125 141 141 141 141 141 141 141 141 141 141 141 141 141 141 141 141 141 141 141 141 125 125 125 125 125 125 125 125 
125 125 125 125 141 141 141 141 141 141 141 141 141 141 141 141 141 141 141 141 141 141 141 141 125 125 125 125 125 125 125 125 

5 
TOMB 272 144
LADDER 320 0 3 0
ENEMY WHITEFIREBALL 224 128
ENEMY WHITEFIREBALL 224 128
ENEMY WHITEFIREBALL 224 128
