32 20
125 125 127 128 127 128 127 128 127 128 127 128 127 128 127 128 127 128 125 125 125 125 125 125 127 128 127 128 127 128 127 128 
125 125 129 130 129 130 129 130 129 130 129 130 129 130 129 130 129 130 125 125 125 125 125 125 129 130 129 130 129 130 129 130 
125 125 128 127 128 127 128 127 128 127 128 127 128 127 128 127 128 127 125 125 125 125 125 125 128 127 128 127 128 127 128 127 
125 125 125 125 125 125 125 125 125 125 125 125 126 126 125 125 125 125 125 125 125 125 125 125 125 125 126 126 125 125 125 125 
125 125 125 125 131 132 131 132 131 132 131 132 131 132 131 132 131 132 131 132 131 135 136 132 131 132 131 132 125 125 125 125 
125 125 125 125 129 130 129 130 129 130 129 130 129 130 129 130 129 130 129 130 129 137 138 130 129 130 129 130 125 125 125 125 
125 125 125 125 128 127 128 127 128 127 128 127 128 127 128 127 128 127 128 127 128 139 140 127 128 127 128 127 125 125 125 125 
125 125 125 125 130 129 130 129 125 125 125 125 125 125 125 125 126 126 125 125 125 125 125 125 125 125 125 125 125 125 125 125 
125 125 125 125 127 128 127 128 131 132 131 132 131 135 136 132 131 132 131 132 131 132 131 132 131 135 136 132 125 125 125 125 
125 125 125 125 129 130 129 130 129 130 129 130 129 137 138 130 129 130 129 130 129 130 129 130 129 137 138 130 125 125 125 125 
125 125 125 125 128 127 128 127 128 127 128 127 128 139 140 127 128 127 128 127 128 127 128 127 128 139 140 127 125 125 125 125 
125 125 125 125 125 125 125 125 125 125 125 125 125 125 125 125 125 125 125 125 130 129 130 129 125 125 125 125 125 125 125 125 
125 125 131 132 131 132 131 132 131 132 131 132 131 132 131 132 131 135 136 132 127 128 127 128 131 132 131 132 125 125 125 125 
125 125 129 130 129 130 129 130 129 130 129 130 129 130 129 130 129 137 138 130 129 130 129 130 129 130 129 130 125 125 125 125 
125 125 128 127 128 127 128 127 128 127 128 127 128 127 128 127 128 139 140 127 128 127 128 127 128 127 128 127 125 125 125 125 
125 125 130 129 130 129 130 129 130 129 130 129 125 125 125 125 125 125 125 125 125 125 125 125 130 129 130 129 125 125 125 125 
125 125 127 128 127 128 127 128 127 128 127 128 131 135 136 132 131 132 131 132 131 132 131 132 127 128 127 128 131 132 131 132 
125 125 129 130 129 130 129 130 129 130 129 130 129 137 138 130 129 130 129 130 129 130 129 130 129 130 129 130 129 130 129 130 
125 125 128 127 128 127 128 127 128 127 128 127 128 139 140 127 128 127 128 127 128 127 128 127 128 127 128 127 128 127 128 127 
125 125 130 129 130 129 130 129 125 125 125 125 125 125 125 125 125 125 125 125 125 125 125 125 125 125 125 125 125 125 125 125 

11 
WKEYDOOR 448 256 1
LADDER 96 0 3 0
LADDER 416 0 3 0
LADDER 416 64 3 0
LADDER 192 64 3 0
LADDER 256 128 3 0
TOMB 144 144
ENEMY GREENMONKEY 224 80
ENEMY GREENMONKEY 288 144
ENEMY GREENMONKEY 288 208
ENEMY GREENMONKEY 160 272
