32 20
125 125 127 128 127 128 127 128 127 128 127 128 127 128 127 128 127 128 125 125 125 125 125 125 125 125 125 125 125 125 125 125 
125 125 129 130 129 130 129 130 129 130 129 130 129 130 129 130 129 130 125 125 125 125 125 125 125 125 125 125 125 125 125 125 
125 125 128 127 128 127 128 127 128 127 128 127 128 127 128 127 128 127 125 125 125 125 125 125 125 125 125 125 125 125 125 125 
125 125 130 129 126 126 125 125 125 125 125 125 130 129 130 129 130 129 125 125 125 125 125 125 125 125 125 125 125 125 125 125 
125 125 127 128 131 132 131 132 131 132 131 132 127 128 127 128 127 128 125 125 125 125 125 125 125 125 125 125 125 125 125 125 
125 125 129 130 129 130 129 130 129 130 129 130 129 130 129 130 129 130 125 125 125 125 125 125 125 125 125 125 125 125 125 125 
125 125 128 127 128 127 128 127 128 127 128 127 128 127 128 127 128 127 125 125 125 125 125 125 125 125 125 125 125 125 125 125 
125 125 130 129 125 125 125 125 125 125 126 126 130 129 130 129 130 129 125 125 125 125 125 125 125 125 125 125 125 125 125 125 
125 125 127 128 131 132 131 132 131 132 131 132 127 128 127 128 127 128 125 125 125 125 125 125 125 125 125 125 125 125 125 125 
125 125 129 130 129 130 129 130 129 130 129 130 129 130 129 130 129 130 125 125 125 125 125 125 125 125 125 125 125 125 125 125 
125 125 128 127 128 127 128 127 128 127 128 127 128 127 128 127 128 127 125 125 125 125 125 125 125 125 125 125 125 125 125 125 
125 125 130 129 126 126 125 125 125 125 125 125 130 129 130 129 130 129 125 125 125 125 125 125 125 125 125 125 125 125 125 125 
125 125 127 128 131 132 131 132 131 132 131 132 127 128 127 128 127 128 125 125 125 125 125 125 125 125 125 125 125 125 125 125 
125 125 129 130 129 130 129 130 129 130 129 130 129 130 129 130 129 130 125 125 125 125 125 125 125 125 125 125 125 125 125 125 
125 125 128 127 128 127 128 127 128 127 128 127 128 127 128 127 128 127 125 125 125 125 125 125 125 125 125 125 125 125 125 125 
125 125 130 129 125 125 125 125 125 125 126 126 130 129 130 129 130 129 125 125 125 125 125 125 125 125 125 125 125 125 125 125 
125 125 127 128 131 132 131 132 131 132 131 132 127 128 127 128 127 128 125 125 125 125 125 125 125 125 125 125 125 125 125 125 
125 125 129 130 129 130 129 130 129 130 129 130 129 130 129 130 129 130 125 125 125 125 125 125 125 125 125 125 125 125 125 125 
125 125 128 127 128 127 128 127 128 127 128 127 128 127 128 127 128 127 125 125 125 125 125 125 125 125 125 125 125 125 125 125 
125 125 125 125 130 129 130 129 130 129 125 125 125 125 125 125 125 125 125 125 125 125 125 125 125 125 125 125 125 125 125 125 

6 
LADDER 256 0 19 0
LADDER 160 256 3 0
LADDER 64 192 3 0
LADDER 160 128 3 0
LADDER 64 64 3 0
WITEM 96 16 
