32 20
127 128 127 128 127 128 127 128 127 128 127 128 127 128 127 128 127 128 127 128 127 128 127 128 127 128 127 128 127 128 127 128 
129 130 129 130 129 130 129 130 129 130 129 130 129 130 129 130 129 130 129 130 129 130 129 130 129 130 129 130 129 130 129 130 
128 127 128 127 128 127 128 127 128 127 128 127 128 127 128 127 128 127 128 127 128 127 128 127 128 127 128 127 128 127 128 127 
125 125 125 125 126 126 130 129 130 129 125 125 125 125 125 125 125 125 125 125 125 125 125 125 125 125 125 125 125 125 125 125 
125 125 131 132 131 132 127 128 127 128 131 132 125 125 125 125 125 125 125 125 131 132 131 132 131 132 131 132 131 135 136 132 
125 125 129 130 129 130 129 130 129 130 129 130 125 125 125 125 125 125 125 125 129 130 129 130 129 130 129 130 129 137 138 130 
125 125 128 127 128 127 128 127 128 127 128 127 125 125 125 125 125 125 125 125 128 127 128 127 128 127 128 127 128 139 140 127 
125 125 130 129 130 129 130 129 130 129 130 129 125 125 125 125 125 125 125 125 130 129 130 129 130 129 130 129 125 125 125 125 
125 125 127 128 127 128 127 128 127 128 127 128 125 125 125 125 125 125 125 125 127 128 127 128 127 128 127 128 131 132 131 132 
125 125 129 130 129 130 129 130 129 130 129 130 125 125 125 125 125 125 125 125 129 130 129 130 129 130 129 130 129 130 129 130 
125 125 128 127 128 127 128 127 128 127 128 127 125 125 125 125 125 125 125 125 128 127 128 127 128 127 128 127 128 127 128 127 
125 125 130 129 130 129 130 129 130 129 130 129 125 125 125 125 125 125 125 125 130 129 130 129 130 129 125 125 125 125 125 125 
125 125 127 128 127 128 127 128 127 128 127 128 125 125 125 125 125 125 125 125 127 128 127 128 127 128 131 132 131 135 136 132 
125 125 129 130 129 130 129 130 129 130 129 130 125 125 125 125 125 125 125 125 129 130 129 130 129 130 129 130 129 137 138 130 
125 125 128 127 128 127 128 127 128 127 128 127 125 125 125 125 125 125 125 125 128 127 128 127 128 127 128 127 128 139 140 127 
125 125 125 125 126 126 125 125 130 129 130 129 125 125 125 125 125 125 125 125 130 129 130 129 125 125 125 125 125 125 125 125 
125 125 131 132 131 132 131 132 127 128 127 128 125 125 125 125 125 125 125 125 127 128 127 128 131 132 131 132 131 132 131 132 
125 125 129 130 129 130 129 130 129 130 129 130 125 125 125 125 125 125 125 125 129 130 129 130 129 130 129 130 129 130 129 130 
125 125 128 127 128 127 128 127 128 127 128 127 125 125 125 125 125 125 125 125 128 127 128 127 128 127 128 127 128 127 128 127 
125 125 125 125 125 125 125 125 125 125 125 125 125 125 125 125 125 125 125 125 125 125 125 125 125 125 125 125 125 125 125 125 

7 
LADDER 32 0 3 0
LADDER 64 64 11 0
LADDER 64 256 3 0
TOMB 400 272
WNOKEYDOOR2 240 0
ENEMY BAT 352 64
ENEMY BAT 288 64
