32 20
125 125 125 125 127 128 127 128 127 128 127 128 127 128 127 128 127 128 127 128 127 128 127 128 127 128 127 128 125 125 125 125 
125 125 125 125 129 130 129 130 129 130 129 130 129 130 129 130 129 130 129 130 129 130 129 130 129 130 129 130 125 125 125 125 
125 125 125 125 128 127 128 127 128 127 128 127 128 127 128 127 128 127 128 127 128 127 128 127 128 127 128 127 125 125 125 125 
125 125 125 125 130 129 130 129 125 125 125 125 125 125 125 125 125 125 126 126 125 125 125 125 125 125 125 125 125 125 125 125 
125 125 125 125 127 128 127 128 125 125 125 125 125 125 125 125 131 132 131 132 125 125 125 125 125 125 125 125 125 125 125 125 
125 125 125 125 129 130 129 130 125 125 125 125 125 125 125 125 129 130 129 130 125 125 125 125 125 125 125 125 125 125 125 125 
125 125 125 125 128 127 128 127 125 125 125 125 125 125 125 125 128 127 128 127 125 125 125 125 125 125 125 125 125 125 125 125 
125 125 125 125 130 129 130 129 125 125 125 125 125 125 125 125 130 129 130 129 125 125 125 125 125 125 125 125 125 125 125 125 
125 125 125 125 127 128 127 128 125 125 125 125 125 125 125 125 127 128 127 128 131 132 131 132 125 125 125 125 125 125 125 125 
125 125 125 125 129 130 129 130 125 125 125 125 125 125 125 125 129 130 129 130 129 130 129 130 125 125 125 125 125 125 125 125 
125 125 125 125 128 127 128 127 125 125 125 125 125 125 125 125 128 127 128 127 128 127 128 127 125 125 125 125 125 125 125 125 
125 125 125 125 130 129 130 129 125 125 125 125 125 125 125 125 130 129 125 125 126 126 130 129 125 125 125 125 125 125 125 125 
125 125 125 125 127 128 127 128 125 125 125 125 125 125 125 125 127 128 131 132 131 132 127 128 125 125 125 125 125 125 125 125 
125 125 125 125 129 130 129 130 125 125 125 125 125 125 125 125 129 130 129 130 129 130 129 130 125 125 125 125 125 125 125 125 
125 125 125 125 128 127 128 127 125 125 125 125 125 125 125 125 128 127 128 127 128 127 128 127 125 125 125 125 125 125 125 125 
125 125 125 125 130 129 130 129 125 125 125 125 125 125 125 125 125 125 125 125 126 126 130 129 125 125 125 125 125 125 125 125 
125 125 125 125 127 128 127 128 125 125 125 125 125 125 125 125 125 125 125 125 131 132 127 128 125 125 125 125 125 125 125 125 
125 125 125 125 129 130 129 130 125 125 125 125 125 125 125 125 125 125 125 125 129 130 129 130 125 125 125 125 125 125 125 125 
125 125 125 125 128 127 128 127 125 125 125 125 125 125 125 125 125 125 125 125 128 127 128 127 125 125 125 125 125 125 125 125 
125 125 125 125 130 129 130 129 125 125 125 125 125 125 125 125 125 125 125 125 130 129 130 129 125 125 125 125 125 125 125 125 

7 
LADDER 320 256 5 0
LADDER 320 192 3 0
LADDER 288 64 7 0
ENEMY FLAME 320 144
ENEMY FLAME 352 16
ENEMY FLAME 256 16
ENEMY FLAME 128 16
