32 20
125 125 127 128 127 128 127 128 127 128 127 128 127 128 127 128 127 128 127 128 127 128 125 125 127 128 127 128 127 128 127 128 
125 125 129 130 129 130 129 130 129 130 129 130 129 130 129 130 129 130 129 130 129 130 125 125 129 130 129 130 129 130 129 130 
125 125 128 127 128 127 128 127 128 127 128 127 128 127 128 127 128 127 128 127 128 127 125 125 128 127 128 127 128 127 128 127 
125 125 125 125 130 129 125 125 125 125 125 125 125 125 125 125 125 125 125 125 130 129 125 125 125 125 125 125 125 125 125 125 
125 125 131 132 127 128 125 125 131 132 131 132 131 135 136 132 131 132 125 125 127 128 131 132 131 135 136 132 131 132 131 132 
125 125 129 130 129 130 125 125 129 130 129 130 129 137 138 130 129 130 125 125 129 130 129 130 129 137 138 130 129 130 129 130 
125 125 128 127 128 127 125 125 128 127 128 127 128 139 140 127 128 127 125 125 128 127 128 127 128 139 140 127 128 127 128 127 
125 125 125 125 125 125 125 125 125 125 130 129 125 125 125 125 130 129 125 125 125 125 130 129 125 125 125 125 130 129 125 125 
125 125 131 132 131 132 131 132 131 132 127 128 131 132 125 125 127 128 131 132 131 132 127 128 125 125 131 132 127 128 125 125 
125 125 129 130 129 130 129 130 129 130 129 130 129 130 125 125 129 130 129 130 129 130 129 130 125 125 129 130 129 130 125 125 
125 125 128 127 128 127 128 127 128 127 128 127 128 127 125 125 128 127 128 127 128 127 128 127 125 125 128 127 128 127 125 125 
125 125 125 125 130 129 125 125 125 125 125 125 130 129 125 125 125 125 125 125 125 125 130 129 125 125 125 125 130 129 125 125 
125 125 131 132 127 128 125 125 131 132 131 132 127 128 125 125 131 132 131 132 131 132 127 128 131 132 125 125 127 128 131 132 
125 125 129 130 129 130 125 125 129 130 129 130 129 130 125 125 129 130 129 130 129 130 129 130 129 130 125 125 129 130 129 130 
125 125 128 127 128 127 125 125 128 127 128 127 128 127 125 125 128 127 128 127 128 127 128 127 128 127 125 125 128 127 128 127 
125 125 130 129 125 125 125 125 130 129 125 125 125 125 125 125 130 129 125 125 130 129 125 125 130 129 125 125 125 125 125 125 
131 132 127 128 125 125 131 132 127 128 131 132 131 135 136 132 127 128 125 125 127 128 125 125 127 128 131 132 131 132 125 125 
129 130 129 130 125 125 129 130 129 130 129 130 129 137 138 130 129 130 125 125 129 130 125 125 129 130 129 130 129 130 125 125 
128 127 128 127 125 125 128 127 128 127 128 127 128 139 140 127 128 127 125 125 128 127 125 125 128 127 128 127 128 127 125 125 
125 125 125 125 125 125 125 125 125 125 125 125 125 125 125 125 125 125 125 125 125 125 125 125 125 125 125 125 125 125 125 125 

5 
WNOKEYDOOR3 128 128
WITEM 400 16 0
TOMB 208 16
ENEMY GORILLA 192 272
ENEMY GORILLA 288 144
