32 20
125 125 127 128 127 128 127 128 127 128 125 125 127 128 127 128 127 128 125 125 127 128 127 128 127 128 127 128 127 128 125 125 
125 125 129 130 129 130 129 130 129 130 125 125 129 130 129 130 129 130 125 125 129 130 129 130 129 130 129 130 129 130 125 125 
125 125 128 127 128 127 128 127 128 127 125 125 128 127 128 127 128 127 125 125 128 127 128 127 128 127 128 127 128 127 125 125 
125 125 125 125 125 125 125 125 130 129 125 125 125 125 125 125 130 129 125 125 125 125 125 125 125 125 130 129 130 129 125 125 
125 125 131 132 131 135 136 132 127 128 131 132 131 132 125 125 127 128 131 132 131 135 136 132 125 125 127 128 127 128 125 125 
125 125 129 130 129 137 138 130 129 130 129 130 129 130 125 125 129 130 129 130 129 137 138 130 125 125 129 130 129 130 125 125 
125 125 128 127 128 139 140 127 128 127 128 127 128 127 125 125 128 127 128 127 128 139 140 127 125 125 128 127 128 127 125 125 
125 125 130 129 125 125 125 125 125 125 130 129 125 125 125 125 130 129 125 125 125 125 125 125 125 125 125 125 130 129 125 125 
125 125 127 128 125 125 131 132 131 132 127 128 131 135 136 132 127 128 131 132 131 132 131 132 125 125 131 132 127 128 125 125 
125 125 129 130 125 125 129 130 129 130 129 130 129 137 138 130 129 130 129 130 129 130 129 130 125 125 129 130 129 130 125 125 
125 125 128 127 125 125 128 127 128 127 128 127 128 139 140 127 128 127 128 127 128 127 128 127 125 125 128 127 128 127 125 125 
125 125 130 129 125 125 125 125 125 125 125 125 125 125 125 125 125 125 125 125 125 125 130 129 125 125 130 129 125 125 125 125 
125 125 127 128 131 132 125 125 131 132 131 132 131 132 125 125 131 132 131 132 125 125 127 128 131 132 127 128 131 132 125 125 
125 125 129 130 129 130 125 125 129 130 129 130 129 130 125 125 129 130 129 130 125 125 129 130 129 130 129 130 129 130 125 125 
125 125 128 127 128 127 125 125 128 127 128 127 128 127 125 125 128 127 128 127 125 125 128 127 128 127 128 127 128 127 125 125 
125 125 125 125 130 129 125 125 125 125 125 125 130 129 125 125 130 129 125 125 125 125 130 129 130 129 125 125 125 125 125 125 
125 125 131 132 127 128 125 125 131 135 136 132 127 128 131 132 127 128 131 132 131 132 127 128 127 128 131 132 131 132 125 125 
125 125 129 130 129 130 125 125 129 137 138 130 129 130 129 130 129 130 129 130 129 130 129 130 129 130 129 130 129 130 125 125 
125 125 128 127 128 127 125 125 128 139 140 127 128 127 128 127 128 127 128 127 128 127 128 127 128 127 128 127 128 127 125 125 
125 125 130 129 125 125 125 125 125 125 125 125 125 125 130 129 125 125 125 125 130 129 125 125 125 125 125 125 125 125 125 125 

11 
WITEM 288 144 2
LADDER 352 0 3 0
TOMB 80 16
ENEMY BAT 256 192
ENEMY BAT 288 256
ENEMY BAT 160 192
ENEMY BAT 96 128
ENEMY BAT 96 64
ENEMY BAT 192 128
ENEMY BAT 320 128
ENEMY BAT 320 64
