32 20
125 125 127 128 127 128 127 128 127 128 127 128 125 125 125 125 125 125 125 125 125 128 127 128 127 128 127 128 127 128 125 125 
125 125 129 130 129 130 129 130 129 130 129 130 125 125 125 125 125 125 125 125 125 130 129 130 129 130 129 130 129 130 125 125 
125 125 128 127 128 127 128 127 128 127 128 127 125 125 125 125 125 125 125 125 125 127 128 127 128 127 128 127 128 127 125 125 
125 125 130 129 130 129 130 129 130 129 125 125 125 125 125 125 125 125 125 125 125 125 125 125 126 126 130 129 130 129 125 125 
125 125 127 128 127 128 127 128 127 128 131 132 125 125 125 125 125 125 125 125 125 125 125 125 131 132 127 128 127 128 125 125 
125 125 129 130 129 130 129 130 129 130 129 130 125 125 125 125 125 125 125 125 125 125 125 125 129 130 129 130 129 130 125 125 
125 125 128 127 128 127 128 127 128 127 128 127 125 125 125 125 125 125 125 125 125 125 125 125 128 127 128 127 128 127 125 125 
125 125 125 125 125 125 125 125 130 129 130 129 125 125 125 125 125 125 125 125 125 125 125 125 130 129 130 129 130 129 125 125 
125 125 131 132 131 132 131 132 127 128 127 128 131 132 131 132 131 135 136 132 131 132 131 132 127 128 127 128 127 128 125 125 
125 125 129 130 129 130 129 130 129 130 129 130 129 130 129 130 129 137 138 130 129 130 129 130 129 130 129 130 129 130 125 125 
125 125 128 127 128 127 128 127 128 127 128 127 128 127 128 127 128 139 140 127 128 127 128 127 128 127 128 127 128 127 125 125 
125 125 125 125 125 125 125 125 126 126 125 125 125 125 130 129 125 125 125 125 125 125 125 125 125 125 125 125 125 125 125 125 
125 125 131 132 131 132 131 132 131 132 131 132 131 132 127 128 131 132 131 132 131 132 131 132 131 135 136 132 131 132 125 125 
125 125 129 130 129 130 129 130 129 130 129 130 129 130 129 130 129 130 129 130 129 130 129 130 129 137 138 0 129 130 125 125 
125 125 128 127 128 127 128 127 128 127 128 127 128 127 128 127 128 127 128 127 128 127 128 127 128 139 140 127 128 127 125 125 
125 125 125 125 130 129 125 125 125 125 130 129 125 125 130 129 125 125 125 125 130 129 125 125 125 125 126 126 125 125 125 125 
125 125 131 132 127 128 131 132 131 132 127 128 131 132 127 128 131 132 131 132 127 128 131 132 131 132 131 132 131 132 125 125 
125 125 129 130 129 130 129 130 129 130 129 130 129 130 129 130 129 130 129 130 129 130 129 130 129 130 129 130 129 130 125 125 
125 125 128 127 128 127 128 127 128 127 128 127 128 127 128 127 128 127 128 127 128 127 128 127 128 127 128 127 128 127 125 125 
125 125 130 129 130 129 130 129 130 129 130 129 130 129 130 129 130 129 130 129 130 129 130 129 130 129 130 129 130 129 125 125 

7 
LADDER 96 0 7 0
LADDER 336 0 3 0
LADDER 384 64 7 0
LADDER 416 256 5 0
TOMB 80 144
LADDER 128 192 3 0
ENEMY GLIZARD 288 144
